absentee_count_progress,absentee_max_ballots,absentee_method,absentee_outstanding,absentee_votes,eevp,eevp_display,eevp_source,eevp_value,fips,last_updated,leader_margin_display,leader_margin_name_display,leader_margin_value,leader_party_id,name,precincts,provisional_count_progress,provisional_outstanding,reporting,tot_exp_vote,turnout_stage,votes,cottont__total_count,republican__total_count,harringtonr__total_count,libertarian__total_count,cottont__absentee_count,harringtonr__absentee_count
unknown,6286,Released as a precinct as first report of the night,,5331,91,91% reported,edison,91%,05001,2020-11-04T10:44:14Z,R+51,Cotton +51,50.55253,republican,Arkansas,30,,,26,6697,2,6063,4564,8579,1499,2815,4015,1316
unknown,5934,Released as a separate subtotal as first report of the night,,7739,98,98% reported,edison,98%,05003,2020-11-04T10:43:22Z,R+50,Cotton +50,49.70926,republican,Ashley,30,,,25,7911,6,7739,5793,11586,1946,3892,5793,1946
some,16848,Merged into voters' home precincts and released with cumulative results,,17292,92,92% reported,edison,92%,05005,2020-11-04T20:24:41Z,R+58,Cotton +58,57.93975,republican,Baxter,43,,,39,22138,4,20347,16068,29626,4279,8013,13558,3734
some,64995,Released as a separate subtotal as first report of the night,,100468,100,>98% reported,edison,>98%,05007,2020-11-06T18:49:47Z,R+30,Cotton +30,29.63937,republican,Benton,117,,,117,117000,4,116767,75688,139962,41079,77273,64274,36194
some,15309,Released as a separate subtotal as first report of the night,,12535,98,98% reported,edison,98%,05009,2020-11-04T10:43:27Z,R+64,Cotton +64,63.66234,republican,Boone,30,,,28,17103,6,16798,13746,23787,3052,5546,10041,2494
unknown,2557,Released as a precinct as first report of the night,,2467,94,94% reported,edison,94%,05011,2020-11-04T10:43:28Z,R+40,Cotton +40,39.63432,republican,Bradley,14,,,12,3767,2,3555,2482,4138,1073,1884,1656,811
unknown,1190,Released as a precinct as first report of the night,,1375,90,90% reported,edison,90%,05013,2020-11-04T10:43:28Z,R+60,Cotton +60,60.0,republican,Calhoun,20,,,17,2340,2,2105,1684,2762,421,718,1078,297
all,6619,Other,,9066,100,>98% reported,edison,>98%,05015,2020-11-05T15:03:42Z,R+33,Cotton +33,32.96607,republican,Carroll,13,,,12,11095,4,11436,7603,13300,3833,7202,5697,3369
unknown,2805,Released as a precinct as first report of the night,,2576,75,75% reported,edison,75%,05017,2020-11-04T10:43:29Z,R+7,Cotton +7,6.58256,republican,Chicot,13,,,10,4884,2,3646,1943,3433,1703,2789,1490,1086
all,6814,Merged into voters' home precincts and released with cumulative results,,11768,100,>98% reported,edison,>98%,05019,2020-11-07T14:59:03Z,R+21,Cotton +21,20.93814,republican,Clark,27,,,23,8358,6,11768,7116,14232,4652,9304,7116,4652
unknown,3371,Other,,1375,95,95% reported,edison,95%,05021,2020-11-04T10:43:29Z,R+65,Cotton +65,64.66431,republican,Clay,17,,,15,5363,2,5094,4194,5302,900,1167,1108,267
some,7784,Other,,8380,99,>98% reported,edison,>98%,05023,2020-11-04T10:43:30Z,R+69,Cotton +69,68.80543,republican,Cleburne,34,,,31,12617,6,12515,10563,17440,1952,3455,6877,1503
unknown,1656,"As a subtotal in the FIRST cumulative report, along with regular precincts",,2134,100,>98% reported,edison,>98%,05025,2020-11-04T10:43:31Z,R+68,Cotton +68,67.9639,republican,Cleveland,17,,,16,3459,2,3546,2978,4712,568,968,1734,400
all,9640,"As a precinct in the FIRST cumulative report, along with regular precincts",,6879,94,94% reported,edison,94%,05027,2020-11-04T10:43:32Z,R+43,Cotton +43,42.99925,republican,Columbia,14,,,11,8550,6,8042,5750,10692,2292,4229,4942,1937
all,5139,Released as a precinct as first report of the night,,5823,98,98% reported,edison,98%,05029,2020-11-04T10:43:33Z,R+39,Cotton +39,39.11509,republican,Conway,31,,,30,8641,6,8498,5911,9703,2587,4618,3792,2031
unknown,28910,Released as a precinct as first report of the night,,27954,99,>98% reported,edison,>98%,05031,2020-11-04T10:43:34Z,R+39,Cotton +39,38.9174,republican,Craighead,53,,,50,38364,6,37798,26254,45188,11544,20564,18934,9020
unknown,10542,Released as a precinct as first report of the night,,18736,95,95% reported,edison,95%,05033,2020-11-04T10:43:35Z,R+57,Cotton +57,56.65958,republican,Crawford,43,,,41,25144,4,23973,18778,33287,5195,9422,14509,4227
unknown,16062,Released as a precinct as first report of the night,,12375,79,79% reported,edison,79%,05035,2020-11-04T10:43:35Z,R+6,Cotton +6,5.83171,republican,Crittenden,22,,,18,18722,2,14867,7867,14535,7000,12707,6668,5707
unknown,6533,Released as a precinct as first report of the night,,5405,95,95% reported,edison,95%,05037,2020-11-04T10:43:36Z,R+51,Cotton +51,50.55712,republican,Cross,21,,,18,7090,2,6731,5067,9112,1664,3024,4045,1360
unknown,2288,Released as a precinct as first report of the night,,1618,74,74% reported,edison,74%,05039,2020-11-04T10:43:36Z,R+36,Cotton +36,36.22047,republican,Dallas,9,,,7,3454,2,2540,1730,2753,810,1405,1023,595
unknown,1597,Released as a precinct as first report of the night,,3053,81,81% reported,edison,81%,05041,2020-11-04T14:56:45Z,R+15,Cotton +15,14.84258,republican,Desha,21,,,18,4950,2,4002,2298,4053,1704,3002,1755,1298
some,5899,Released as a precinct as first report of the night,,5253,98,98% reported,edison,98%,05043,2020-11-04T10:43:37Z,R+36,Cotton +36,36.19503,republican,Drew,19,,,17,6841,2,6686,4553,8091,2133,3848,3538,1715
some,39644,Released as a precinct as first report of the night,,45979,99,>98% reported,edison,>98%,05045,2020-11-04T10:43:38Z,R+32,Cotton +32,31.99947,republican,Faulkner,51,,,51,54000,4,53329,35197,65225,18132,34083,30028,15951
unknown,4789,Merged into voters' home precincts and released with cumulative results,,5426,100,>98% reported,edison,>98%,05047,2020-11-04T17:48:40Z,R+60,Cotton +60,59.90345,republican,Franklin,39,,,36,6982,2,7043,5631,9931,1412,2538,4300,1126
some,3222,Released as a precinct in the middle of the night,,3451,97,97% reported,edison,97%,05049,2020-11-04T10:43:39Z,R+62,Cotton +62,61.74158,republican,Fulton,10,,,9,5098,6,4961,4012,6722,949,1690,2710,741
some,38437,"As a subtotal in the FIRST cumulative report, along with regular precincts",,37987,96,96% reported,edison,96%,05051,2020-11-06T13:55:35Z,R+39,Cotton +39,39.04914,republican,Garland,56,,,53,45702,2,43750,30417,56494,13333,25243,26077,11910
all,3816,Released as a precinct as first report of the night,,5991,100,>98% reported,edison,>98%,05053,2020-11-04T10:43:42Z,R+69,Cotton +69,68.66879,republican,Grant,18,,,18,8197,6,8158,6880,11860,1278,2289,4980,1011
unknown,12003,Released separately AFTER election night,,13007,97,97% reported,edison,97%,05055,2020-11-04T10:43:42Z,R+62,Cotton +62,62.08795,republican,Greene,66,,,64,16352,2,15805,12809,23294,2996,5518,10485,2522
unknown,4430,Released as a separate subtotal as first report of the night,,4485,100,>98% reported,edison,>98%,05057,2020-11-07T15:00:21Z,R+49,Cotton +49,49.37391,republican,Hempstead,24,,,24,7270,4,11500,8589,11616,2911,4369,3027,1458
unknown,6128,Released as a separate subtotal as first report of the night,,10311,92,92% reported,edison,92%,05059,2020-11-04T10:43:43Z,R+52,Cotton +52,51.78064,republican,Hot Spring,31,,,29,13377,2,12327,9355,17110,2972,5528,7755,2556
unknown,3030,Merged into voters' home precincts AFTER election night,,4378,97,97% reported,edison,97%,05061,2020-11-04T10:43:44Z,R+51,Cotton +51,51.19556,republican,Howard,36,,,32,4821,2,4684,3541,6894,1143,2168,3353,1025
unknown,7256,Released as a separate subtotal at the end of tabulation,,10797,100,>98% reported,edison,>98%,05063,2020-11-04T10:43:44Z,R+62,Cotton +62,61.84451,republican,Independence,34,,,32,14041,2,14226,11512,20119,2714,4904,8607,2190
unknown,3837,"As a precinct in the FIRST cumulative report, along with regular precincts",,4044,100,>98% reported,edison,>98%,05065,2020-11-04T10:43:45Z,R+66,Cotton +66,65.78067,republican,Izard,47,,,44,5619,2,5681,4709,7989,972,1736,3280,764
unknown,4320,Released as a precinct at the end of tabulation,,3385,97,97% reported,edison,97%,05067,2020-11-04T10:43:45Z,R+52,Cotton +52,51.9902,republican,Jackson,45,,,38,5076,6,4899,3723,6190,1176,2094,2467,918
unknown,18848,Released as a separate subtotal as first report of the night,,15558,78,78% reported,edison,78%,05069,2020-11-04T10:43:45Z,L+6,Harrington +6,6.13333,libertarian,Jefferson,170,,,141,30669,2,24000,11264,17427,12736,22131,6163,9395
unknown,5392,Released as a separate subtotal as first report of the night,,6355,99,>98% reported,edison,>98%,05071,2020-11-04T10:43:46Z,R+50,Cotton +50,50.00538,republican,Johnson,22,,,20,9397,2,9297,6973,11570,2324,4082,4597,1758
unknown,2162,Released as a separate subtotal as first report of the night,,2222,76,76% reported,edison,76%,05073,2020-11-04T10:43:46Z,R+44,Cotton +44,44.27542,republican,Lafayette,25,,,19,3280,2,2498,1802,3434,696,1286,1632,590
unknown,3298,Released as a precinct as first report of the night,,3926,98,98% reported,edison,98%,05075,2020-11-04T10:43:47Z,R+65,Cotton +65,65.23999,republican,Lawrence,28,,,25,5863,2,5771,4768,7946,1003,1751,3178,748
unknown,2378,"As a subtotal in the FIRST cumulative report, along with regular precincts",,1867,66,66% reported,edison,66%,05077,2020-11-04T10:43:48Z,R+11,Cotton +11,10.8055,republican,Lee,9,,,7,3835,2,2545,1410,2364,1135,2048,954,913
unknown,2160,Released as a separate subtotal as first report of the night,,2220,98,98% reported,edison,98%,05079,2020-11-04T10:43:50Z,R+53,Cotton +53,52.93808,republican,Lincoln,26,,,23,3870,6,3795,2902,4617,893,1398,1715,505
all,2893,Merged into voters' home precincts AFTER election night,,4002,97,97% reported,edison,97%,05081,2020-11-04T10:43:51Z,R+55,Cotton +55,54.71022,republican,Little River,22,,,19,5178,6,5021,3884,6941,1137,2082,3057,945
unknown,4488,Merged into voters' home precincts and released with cumulative results,,5761,100,>98% reported,edison,>98%,05083,2020-11-04T20:10:43Z,R+60,Cotton +60,59.53517,republican,Logan,36,,,33,8170,2,8175,6521,11048,1654,2888,4527,1234
unknown,20792,Released as a separate subtotal as first report of the night,,26254,100,>98% reported,edison,>98%,05085,2020-11-04T10:43:52Z,R+55,Cotton +55,54.68755,republican,Lonoke,55,,,55,30352,2,30389,23504,43809,6885,12834,20305,5949
all,3048,Released as a precinct as first report of the night,,4332,98,98% reported,edison,98%,05087,2020-11-04T10:43:52Z,R+56,Cotton +56,56.08193,republican,Madison,10,,,9,7315,6,7177,5601,8796,1576,2713,3195,1137
some,5478,Released as a separate subtotal as first report of the night,,5210,98,98% reported,edison,98%,05089,2020-11-04T10:43:52Z,R+61,Cotton +61,60.8601,republican,Marion,31,,,29,7481,6,7348,5910,10005,1438,2553,4095,1115
unknown,11867,Released as a separate subtotal as first report of the night,,12465,89,89% reported,edison,89%,05091,2020-11-05T16:29:41Z,R+53,Cotton +53,52.89561,republican,Miller,19,,,17,18022,2,16007,12237,21639,3770,6833,9402,3063
unknown,13013,Released as a separate subtotal as first report of the night,,8767,84,84% reported,edison,84%,05093,2020-11-04T10:43:53Z,R+34,Cotton +34,33.5052,republican,Mississippi,18,,,14,13794,2,11637,7768,13412,3869,6992,5644,3123
unknown,1656,Released as a separate subtotal as first report of the night,,1722,75,75% reported,edison,75%,05095,2020-11-04T10:43:54Z,R+26,Cotton +26,26.15724,republican,Monroe,8,,,7,3618,2,2722,1717,2828,1005,1616,1111,611
unknown,2037,"As a subtotal in the FIRST cumulative report, along with regular precincts",,2734,100,>98% reported,edison,>98%,05097,2020-11-04T10:43:54Z,R+63,Cotton +63,63.32893,republican,Montgomery,16,,,15,3671,2,3785,3091,5260,694,1259,2169,565
unknown,1874,Released as a separate subtotal as first report of the night,,1715,96,96% reported,edison,96%,05099,2020-11-04T10:43:55Z,R+42,Cotton +42,42.13953,republican,Nevada,15,,,13,3358,6,3225,2292,3485,933,1455,1193,522
unknown,2074,Released as a separate subtotal at the end of tabulation,,2030,100,>98% reported,edison,>98%,05101,2020-11-04T23:10:45Z,R+63,Cotton +63,62.50322,republican,Newton,19,,,17,3870,2,3883,3155,4692,728,1221,1537,493
unknown,8051,Released as a separate subtotal as first report of the night,,7417,76,76% reported,edison,76%,05103,2020-11-04T10:43:57Z,R+30,Cotton +30,30.05027,republican,Ouachita,19,,,15,11553,2,8752,5691,10409,3061,5760,4718,2699
unknown,2160,"As a precinct in the FIRST cumulative report, along with regular precincts",,3230,99,>98% reported,edison,>98%,05105,2020-11-04T10:43:58Z,R+56,Cotton +56,55.70706,republican,Perry,17,,,16,4607,6,4547,3540,6015,1007,1762,2475,755
all,6973,Released as a separate subtotal as first report of the night,,3693,91,91% reported,edison,91%,05107,2020-11-04T10:43:59Z,L+1.6,Harrington +1.6,1.55719,libertarian,Phillips,16,,,11,6155,6,5587,2750,4296,2837,4984,1546,2147
all,2610,Merged into voters' home precincts and released with cumulative results,,3212,99,>98% reported,edison,>98%,05109,2020-11-06T19:56:34Z,R+71,Cotton +71,70.93936,republican,Pike,11,,,10,4240,6,4205,3594,6306,611,1111,2712,500
unknown,2501,Released as a separate subtotal as first report of the night,,4185,92,92% reported,edison,92%,05111,2020-11-04T10:43:59Z,R+65,Cotton +65,64.58049,republican,Poinsett,9,,,8,7964,2,7318,6022,9418,1296,2085,3396,789
unknown,5582,Released as a separate subtotal as first report of the night,,6246,99,>98% reported,edison,>98%,05113,2020-11-04T10:44:00Z,R+69,Cotton +69,68.54656,republican,Polk,17,,,15,8489,2,8387,7068,12247,1319,2386,5179,1067
all,17896,Released as a separate subtotal as first report of the night,,20426,95,95% reported,edison,95%,05115,2020-11-04T10:44:00Z,R+52,Cotton +52,52.48018,republican,Pope,55,,,52,25277,4,24091,18367,33842,5724,10675,15475,4951
unknown,1421,Merged into voters' home precincts and released with cumulative results,,1969,95,95% reported,edison,95%,05117,2020-11-04T10:44:01Z,R+68,Cotton +68,68.27381,republican,Prairie,25,,,22,3552,2,3360,2827,4432,533,897,1605,364
all,127309,Released as a separate subtotal as first report of the night,,127926,90,90% reported,edison,90%,05119,2020-11-04T10:44:01Z,L+13,Harrington +13,12.86601,libertarian,Pulaski,137,,,124,178949,4,161503,70362,121931,91141,167498,51569,76357
some,5349,Released as a separate subtotal as first report of the night,,4961,98,98% reported,edison,98%,05121,2020-11-04T10:44:01Z,R+64,Cotton +64,64.118,republican,Randolph,29,,,27,6769,6,6644,5452,9461,1192,2144,4009,952
unknown,5859,Released as a separate subtotal as first report of the night,,4492,69,69% reported,edison,69%,05123,2020-11-04T10:44:02Z,R+11,Cotton +11,11.31812,republican,Saint Francis,15,,,12,9365,2,6441,3585,5929,2856,5004,2344,2148
all,38510,Released as a separate subtotal as first report of the night,,47429,99,>98% reported,edison,>98%,05125,2020-11-04T10:44:02Z,R+47,Cotton +47,46.65698,republican,Saline,42,,,41,56903,6,56461,41402,75652,15059,28238,34250,13179
unknown,1949,Released as a separate subtotal as first report of the night,,2092,59,59% reported,edison,59%,05127,2020-11-04T10:44:02Z,R+66,Cotton +66,65.87807,republican,Scott,26,,,15,3754,2,2198,1823,3556,375,734,1733,359
unknown,3016,Released as a precinct as first report of the night,,2819,100,>98% reported,edison,>98%,05129,2020-11-04T10:44:02Z,R+70,Cotton +70,69.6061,republican,Searcy,15,,,14,3845,2,3935,3337,5702,598,1052,2365,454
all,30462,Released as a separate subtotal as first report of the night,,37215,93,93% reported,edison,93%,05131,2020-11-04T10:44:03Z,R+37,Cotton +37,36.80996,republican,Sebastian,117,,,109,49993,2,46501,31809,56784,14692,26932,24975,12240
unknown,2310,Released as a separate subtotal as first report of the night,,3397,100,>98% reported,edison,>98%,05133,2020-11-04T10:44:04Z,R+61,Cotton +61,60.69681,republican,Sevier,17,,,17,4705,2,5109,4105,6774,1004,1732,2669,728
unknown,5603,Released as a separate subtotal as first report of the night,,5731,98,98% reported,edison,98%,05135,2020-11-04T10:44:05Z,R+64,Cotton +64,64.40357,republican,Sharp,25,,,23,7511,2,7394,6078,10721,1316,2404,4643,1088
unknown,4534,Released as a precinct in the middle of the night,,4018,98,98% reported,edison,98%,05137,2020-11-04T10:44:06Z,R+59,Cotton +59,58.70946,republican,Stone,19,,,18,5919,6,5827,4624,7739,1203,2106,3115,903
unknown,12974,Released as a separate subtotal as first report of the night,,9730,90,90% reported,edison,90%,05139,2020-11-04T10:44:07Z,R+41,Cotton +41,40.94439,republican,Union,28,,,24,17715,2,15968,11253,17706,4715,7992,6453,3277
unknown,4338,Released as a precinct as first report of the night,,6002,100,>98% reported,edison,>98%,05141,2020-11-04T10:44:07Z,R+60,Cotton +60,60.41281,republican,Van Buren,21,,,19,7569,2,7558,6062,10789,1496,2771,4727,1275
unknown,43475,Released as a separate subtotal as first report of the night,,72690,100,>98% reported,edison,>98%,05143,2020-11-04T10:44:08Z,R+7,Cotton +7,6.87657,republican,Washington,154,,,154,91684,2,91790,49051,85931,42739,78549,36880,35810
unknown,18262,Merged into voters' home precincts and released with cumulative results,,21856,97,97% reported,edison,97%,05145,2020-11-04T18:52:41Z,R+62,Cotton +62,61.95368,republican,White,93,,,90,31359,2,30568,24753,42165,5815,10259,17412,4444
unknown,1078,Merged into voters' home precincts and released with cumulative results,,1354,87,87% reported,edison,87%,05147,2020-11-04T10:44:08Z,R+40,Cotton +40,40.38143,republican,Woodruff,20,,,17,2769,2,2412,1693,2590,719,1176,897,457
unknown,3608,Released as a precinct as first report of the night,,4819,100,>98% reported,edison,>98%,05149,2020-11-04T10:44:09Z,R+60,Cotton +60,60.45079,republican,Yell,28,,,26,6641,2,6655,5339,9137,1316,2337,3798,1021
