absentee_count_progress,absentee_max_ballots,absentee_method,absentee_outstanding,absentee_votes,eevp,eevp_display,eevp_source,eevp_value,fips,last_updated,leader_margin_display,leader_margin_name_display,leader_margin_value,leader_party_id,name,precincts,provisional_count_progress,provisional_outstanding,reporting,tot_exp_vote,turnout_stage,votes,ernstj__total_count,republican__total_count,greenfieldt__total_count,democrat__total_count,herzogs__total_count,independent__total_count,stewartr__total_count,libertarian__total_count,ernstj__absentee_count,greenfieldt__absentee_count,herzogs__absentee_count,stewartr__absentee_count
all,,None,,2051,99,>98% reported,edison,>98%,19001,2020-11-04T10:44:02Z,R+39,Ernst +39,38.705,republican,Adair,5,,,5,4171,6,4139,2808,3992,1206,2009,36,62,89,127,1184,803,26,38
all,,None,,1237,100,>98% reported,edison,>98%,19003,2020-11-04T10:44:02Z,R+42,Ernst +42,41.92201,republican,Adams,5,,,5,2154,6,2154,1496,2276,593,1013,19,34,46,68,780,420,15,22
all,,None,,4775,100,>98% reported,edison,>98%,19005,2020-11-04T10:44:03Z,R+26,Ernst +26,25.57283,republican,Allamakee,11,,,11,7152,4,7332,4476,7070,2601,4633,80,124,175,280,2594,2032,44,105
unknown,,None,,3145,100,>98% reported,edison,>98%,19007,2020-11-04T10:44:04Z,R+35,Ernst +35,34.98981,republican,Appanoose,13,,,12,6406,2,6379,4186,5890,1954,3287,71,111,168,236,1704,1333,40,68
unknown,,None,,2002,95,95% reported,edison,95%,19009,2020-11-04T10:44:05Z,R+33,Ernst +33,32.51188,republican,Audubon,3,,,3,3559,2,3368,2186,3345,1091,1887,21,31,70,107,1159,796,10,37
none,,None,,6401,98,98% reported,edison,98%,19011,2020-11-04T10:44:05Z,R+25,Ernst +25,25.05529,republican,Benton,19,,,17,14703,4,14468,8822,11896,5197,8337,119,168,330,468,3074,3140,49,138
unknown,,None,,40598,85,85% reported,edison,85%,19013,2020-11-04T10:44:06Z,D+9,Greenfield +9,8.69822,democrat,Black Hawk,63,,,62,77548,4,65933,29204,43253,34939,60555,490,769,1300,1954,14049,25616,279,654
some,,None,,9366,100,>98% reported,edison,>98%,19015,2020-11-04T10:44:07Z,R+13,Ernst +13,13.15164,republican,Boone,13,,,13,15057,4,15154,8299,12490,6306,11199,166,252,383,579,4191,4893,86,196
all,,None,,8296,92,92% reported,edison,92%,19017,2020-11-04T10:44:07Z,R+16,Ernst +16,15.83177,republican,Bremer,14,,,14,15704,4,14433,8190,11962,5905,10264,84,130,254,373,3772,4359,46,119
all,,None,,5517,97,97% reported,edison,97%,19019,2020-11-04T10:44:08Z,R+17,Ernst +17,16.56849,republican,Buchanan,11,,,11,11039,4,10695,6062,8531,4290,7180,96,147,247,354,2469,2890,51,107
some,,None,,3667,90,90% reported,edison,90%,19021,2020-11-04T10:44:08Z,R+21,Ernst +21,21.37337,republican,Buena Vista,8,,,8,8782,4,7893,4670,6478,2983,4734,75,112,165,236,1808,1751,37,71
unknown,,None,,4138,100,>98% reported,edison,>98%,19023,2020-11-04T10:44:08Z,R+35,Ernst +35,35.19051,republican,Butler,8,,,7,7770,2,8005,5290,7685,2473,4111,69,107,173,240,2395,1638,38,67
unknown,,None,,2493,95,95% reported,edison,95%,19025,2020-11-04T10:44:09Z,R+38,Ernst +38,38.09341,republican,Calhoun,11,,,10,5469,2,5203,3512,4918,1530,2531,32,45,129,202,1406,1001,13,73
unknown,,None,,6237,99,>98% reported,edison,>98%,19027,2020-11-04T10:44:09Z,R+33,Ernst +33,32.91378,republican,Carroll,14,,,13,11193,2,11123,7230,10665,3569,6225,96,139,228,331,3435,2656,43,103
some,,None,,4157,99,>98% reported,edison,>98%,19029,2020-11-07T22:49:50Z,R+34,Ernst +34,34.45096,republican,Cass,10,,,10,7265,6,7158,4725,7172,2259,3882,54,82,120,179,2447,1623,28,59
all,,None,,5886,100,>98% reported,edison,>98%,19031,2020-11-04T10:44:09Z,R+16,Ernst +16,15.5197,republican,Cedar,12,,,12,10108,4,10535,5935,8612,4300,7377,74,112,226,320,2677,3077,38,94
some,,None,,13849,94,94% reported,edison,94%,19033,2020-11-04T10:44:10Z,D+0.85,Greenfield +0.85,0.84652,democrat,Cerro Gordo,27,,,26,24941,4,23508,11334,16580,11533,19827,211,316,430,634,5246,8294,105,204
unknown,,None,,3943,96,96% reported,edison,96%,19035,2020-11-07T22:49:49Z,R+34,Ernst +34,34.44946,republican,Cherokee,7,,,6,6716,2,6421,4214,6506,2002,3537,67,110,138,211,2292,1535,43,73
unknown,,None,,4239,99,>98% reported,edison,>98%,19037,2020-11-04T10:44:10Z,R+26,Ernst +26,25.79957,republican,Chickasaw,14,,,12,6605,6,6566,4015,6259,2321,4181,71,105,159,260,2244,1860,34,101
all,,None,,2521,99,>98% reported,edison,>98%,19039,2020-11-04T10:44:10Z,R+30,Ernst +30,30.03695,republican,Clarke,8,,,8,4666,6,4601,2902,4207,1520,2647,60,89,119,179,1305,1127,29,60
unknown,,None,,5577,98,98% reported,edison,98%,19041,2020-11-04T10:44:10Z,R+32,Ernst +32,32.30003,republican,Clay,12,,,11,9065,2,8839,5706,8922,2851,5075,89,130,193,289,3216,2224,41,96
none,,None,,4690,100,>98% reported,edison,>98%,19043,2020-11-04T10:44:11Z,R+25,Ernst +25,25.33628,republican,Clayton,14,,,14,9431,2,9516,5844,8083,3433,5767,82,135,157,221,2239,2334,53,64
unknown,,None,,15725,93,93% reported,edison,93%,19045,2020-11-04T10:44:11Z,R+7,Ernst +7,6.62829,republican,Clinton,26,,,24,26195,2,24320,12549,19115,10937,19597,200,332,634,1001,6566,8660,132,367
unknown,,None,,4038,97,97% reported,edison,97%,19047,2020-11-04T10:44:11Z,R+30,Ernst +30,29.93694,republican,Crawford,8,,,7,7165,2,6978,4415,6675,2326,3962,78,127,159,252,2260,1636,49,93
some,,None,,33813,99,>98% reported,edison,>98%,19049,2020-11-04T10:44:11Z,R+6,Ernst +6,5.9303,republican,Dallas,34,,,34,56000,4,55326,28614,43004,25333,44076,379,582,1000,1477,14390,18743,203,477
all,,None,,2148,99,>98% reported,edison,>98%,19051,2020-11-07T22:49:49Z,R+39,Ernst +39,38.64818,republican,Davis,8,,,7,4097,6,4039,2728,3974,1167,1995,32,52,112,166,1246,828,20,54
all,,None,,1650,98,98% reported,edison,98%,19053,2020-11-04T10:44:12Z,R+34,Ernst +34,34.14634,republican,Decatur,7,,,7,3798,6,3731,2436,3288,1162,1915,43,59,90,119,852,753,16,29
unknown,,None,,4784,100,>98% reported,edison,>98%,19055,2020-11-07T22:49:49Z,R+32,Ernst +32,32.41039,republican,Delaware,12,,,11,9651,2,9932,6454,9033,3235,5326,71,110,172,247,2579,2091,39,75
unknown,,None,,12526,92,92% reported,edison,92%,19057,2020-11-04T10:44:12Z,R+0.89,Ernst +0.89,0.89381,republican,Des Moines,17,,,15,21340,2,19579,9466,14458,9291,16369,232,363,590,915,4992,7078,131,325
unknown,,None,,7821,93,93% reported,edison,93%,19059,2020-11-04T10:44:13Z,R+30,Ernst +30,30.06355,republican,Dickinson,6,,,6,12011,2,11173,7146,11814,3787,6806,66,105,174,269,4668,3019,39,95
unknown,,None,,33818,90,90% reported,edison,90%,19061,2020-11-06T14:12:37Z,R+1.1,Ernst +1.1,1.13309,republican,Dubuque,36,,,36,58809,4,53041,26033,38836,25432,45540,428,718,1148,1765,12803,20108,290,617
unknown,,None,,2581,96,96% reported,edison,96%,19063,2020-11-07T22:49:48Z,R+28,Ernst +28,27.68974,republican,Emmet,12,,,10,5000,2,4796,2965,4288,1637,2818,47,63,147,208,1323,1181,16,61
all,,None,,5370,99,>98% reported,edison,>98%,19065,2020-11-07T22:49:48Z,R+19,Ernst +19,19.35803,republican,Fayette,26,,,26,10176,6,10094,5865,8355,3911,6648,89,137,229,324,2490,2737,48,95
some,,None,,4605,92,92% reported,edison,92%,19067,2020-11-04T10:43:28Z,R+9,Ernst +9,8.60769,republican,Floyd,9,,,9,8668,4,7958,4179,6144,3494,5993,98,144,187,282,1965,2499,46,95
unknown,,None,,2488,95,95% reported,edison,95%,19069,2020-11-07T22:49:48Z,R+32,Ernst +32,32.23892,republican,Franklin,13,,,11,5319,2,5056,3268,4662,1638,2671,50,68,100,143,1394,1033,18,43
all,,None,,2028,99,>98% reported,edison,>98%,19071,2020-11-04T10:43:30Z,R+39,Ernst +39,38.52825,republican,Fremont,6,,,6,3849,6,3805,2563,3777,1097,1847,56,78,89,131,1214,750,22,42
unknown,,None,,3112,99,>98% reported,edison,>98%,19073,2020-11-04T10:43:31Z,R+26,Ernst +26,25.62663,republican,Greene,7,,,7,5054,6,4987,3061,4707,1783,3181,39,56,104,155,1646,1398,17,51
some,,None,,3294,99,>98% reported,edison,>98%,19075,2020-11-04T10:43:31Z,R+39,Ernst +39,38.65219,republican,Grundy,7,,,7,7281,4,7182,4884,6779,2108,3431,37,56,153,210,1895,1323,19,57
unknown,,None,,3303,100,>98% reported,edison,>98%,19077,2020-11-04T10:43:33Z,R+33,Ernst +33,33.31223,republican,Guthrie,9,,,9,6160,2,6319,4103,5909,1998,3402,56,76,162,235,1806,1404,20,73
all,,None,,4620,99,>98% reported,edison,>98%,19079,2020-11-04T10:43:34Z,R+22,Ernst +22,22.45106,republican,Hamilton,8,,,8,7916,6,7866,4679,7016,2913,5049,84,130,190,291,2337,2136,46,101
some,,None,,2849,98,98% reported,edison,98%,19081,2020-11-04T10:43:35Z,R+35,Ernst +35,34.95881,republican,Hancock,11,,,10,6215,4,6070,4001,5583,1879,3075,60,89,130,172,1582,1196,29,42
unknown,,None,,4777,95,95% reported,edison,95%,19083,2020-11-04T10:43:36Z,R+31,Ernst +31,30.78318,republican,Hardin,8,,,7,9312,2,8823,5630,8214,2914,4964,84,130,195,292,2584,2050,46,97
unknown,,None,,3912,100,>98% reported,edison,>98%,19085,2020-11-04T10:43:36Z,R+31,Ernst +31,31.03664,republican,Harrison,13,,,12,7712,2,7997,5054,7134,2572,4240,118,168,253,367,2080,1668,50,114
unknown,,None,,6207,96,96% reported,edison,96%,19087,2020-11-04T10:43:37Z,R+25,Ernst +25,24.79432,republican,Henry,10,,,9,10133,2,9724,5855,9214,3444,6037,116,192,309,488,3359,2593,76,179
all,,None,,2505,99,>98% reported,edison,>98%,19089,2020-11-04T10:43:37Z,R+14,Ernst +14,14.29154,republican,Howard,9,,,9,4951,6,4905,2715,3780,2014,3373,58,83,118,174,1065,1359,25,56
unknown,,None,,2812,97,97% reported,edison,97%,19091,2020-11-07T22:49:52Z,R+42,Ernst +42,42.33036,republican,Humboldt,10,,,9,5396,2,5261,3670,5364,1443,2490,40,57,108,162,1694,1047,17,54
all,,None,,1856,99,>98% reported,edison,>98%,19093,2020-11-04T10:43:39Z,R+47,Ernst +47,47.04802,republican,Ida,8,,,7,3845,6,3811,2755,3927,962,1603,28,42,66,95,1172,641,14,29
all,,None,,5478,99,>98% reported,edison,>98%,19095,2020-11-07T22:49:48Z,R+23,Ernst +23,23.42305,republican,Iowa,11,,,11,9702,6,9623,5794,8576,3540,6090,84,124,205,311,2782,2550,40,106
unknown,,None,,6120,100,>98% reported,edison,>98%,19097,2020-11-07T22:49:51Z,R+18,Ernst +18,17.65677,republican,Jackson,17,,,15,10652,2,10908,6175,8943,4249,7309,118,189,366,587,2768,3060,71,221
all,,None,,10739,97,97% reported,edison,97%,19099,2020-11-07T20:14:45Z,R+17,Ernst +17,17.49388,republican,Jasper,20,,,20,20653,6,20007,11405,16190,7905,13543,166,245,531,768,4785,5638,79,237
some,,None,,6039,90,90% reported,edison,90%,19101,2020-11-04T10:43:43Z,D+6,Greenfield +6,6.09645,democrat,Jefferson,12,,,12,9789,4,8792,4007,6026,4543,8432,80,123,162,250,2019,3889,43,88
unknown,,None,,59712,92,92% reported,edison,92%,19103,2020-11-06T14:12:36Z,D+40,Greenfield +40,40.30646,democrat,Johnson,58,,,54,89250,2,82555,23763,35551,57038,103941,373,620,1381,2155,11788,46903,247,774
unknown,,None,,5967,100,>98% reported,edison,>98%,19105,2020-11-04T10:43:44Z,R+19,Ernst +19,19.1167,republican,Jones,14,,,13,10744,2,10891,6317,9059,4235,7293,68,106,271,400,2742,3058,38,129
unknown,,None,,2296,98,98% reported,edison,98%,19107,2020-11-04T10:43:45Z,R+40,Ernst +40,39.87281,republican,Keokuk,11,,,11,5273,6,5189,3553,4845,1484,2429,52,72,100,139,1292,945,20,39
unknown,,None,,4977,98,98% reported,edison,98%,19109,2020-11-04T10:43:45Z,R+35,Ernst +35,35.07479,republican,Kossuth,20,,,18,9178,2,8958,5925,8692,2783,4877,57,88,193,278,2767,2094,31,85
unknown,,None,,9736,85,85% reported,edison,85%,19111,2020-11-04T10:43:46Z,R+6,Ernst +6,6.30445,republican,Lee,19,,,19,19417,4,16528,8482,12457,7440,12915,122,188,484,704,3975,5475,66,220
all,,None,,80620,92,92% reported,edison,92%,19113,2020-11-04T10:43:47Z,D+13,Greenfield +13,12.55153,democrat,Linn,86,,,80,136737,4,125666,52970,78442,68743,121803,805,1298,3148,4743,25472,53060,493,1595
unknown,,None,,2728,100,>98% reported,edison,>98%,19115,2020-11-07T22:49:47Z,R+28,Ernst +28,27.68792,republican,Louisa,5,,,5,5173,2,5255,3259,4698,1804,2997,51,78,141,210,1439,1193,27,69
all,,None,,2472,97,97% reported,edison,97%,19117,2020-11-04T10:43:50Z,R+38,Ernst +38,38.10662,republican,Lucas,8,,,8,4299,6,4183,2824,4301,1230,2159,38,58,91,137,1477,929,20,46
unknown,,None,,3282,99,>98% reported,edison,>98%,19119,2020-11-04T10:43:51Z,R+66,Ernst +66,65.97953,republican,Lyon,8,,,7,6824,2,6743,5519,7998,1070,1797,50,79,104,151,2479,727,29,47
unknown,,None,,5253,99,>98% reported,edison,>98%,19121,2020-11-04T10:43:51Z,R+32,Ernst +32,31.74734,republican,Madison,10,,,10,9795,6,9689,6231,9051,3155,5459,86,118,217,314,2820,2304,32,97
all,,None,,6677,98,98% reported,edison,98%,19123,2020-11-04T10:43:52Z,R+44,Ernst +44,43.62627,republican,Mahaska,12,,,11,11374,4,11163,7824,12056,2954,5192,117,180,268,412,4232,2238,63,144
unknown,,None,,10094,99,>98% reported,edison,>98%,19125,2020-11-04T10:43:52Z,R+31,Ernst +31,31.21946,republican,Marion,17,,,17,19217,6,19033,12205,17624,6263,10667,144,211,421,625,5419,4404,67,204
some,,None,,11273,89,89% reported,edison,89%,19127,2020-11-04T10:43:53Z,R+5,Ernst +5,4.87162,republican,Marshall,19,,,19,19950,4,17838,9050,13875,8181,14273,165,272,442,691,4825,6092,107,249
some,,None,,5001,100,>98% reported,edison,>98%,19129,2020-11-04T10:43:53Z,R+34,Ernst +34,34.43228,republican,Mills,12,,,11,8099,4,8129,5335,8352,2536,4369,81,137,177,272,3017,1833,56,95
unknown,,None,,3444,100,>98% reported,edison,>98%,19131,2020-11-04T10:43:54Z,R+18,Ernst +18,18.28868,republican,Mitchell,11,,,10,5729,2,5785,3336,4979,2278,3980,49,81,122,189,1643,1702,32,67
unknown,,None,,2155,95,95% reported,edison,95%,19133,2020-11-05T21:19:40Z,R+34,Ernst +34,34.33061,republican,Monona,8,,,7,4869,2,4646,3047,4212,1452,2379,39,56,108,154,1165,927,17,46
all,,None,,2242,100,>98% reported,edison,>98%,19135,2020-11-07T22:49:47Z,R+40,Ernst +40,39.77046,republican,Monroe,8,,,7,3993,4,4008,2742,4067,1148,2001,34,54,84,128,1325,853,20,44
unknown,,None,,2886,100,>98% reported,edison,>98%,19137,2020-11-04T10:43:57Z,R+40,Ernst +40,39.84877,republican,Montgomery,3,,,3,5211,2,5290,3627,5360,1519,2605,46,65,98,146,1733,1086,19,48
all,,None,,12042,98,98% reported,edison,98%,19139,2020-11-05T22:08:36Z,R+4,Ernst +4,4.39103,republican,Muscatine,23,,,23,20806,4,20428,10278,15227,9381,16069,199,321,570,853,4949,6688,122,283
some,,None,,3589,96,96% reported,edison,96%,19141,2020-11-04T10:43:59Z,R+54,Ernst +54,54.06602,republican,O'Brien,9,,,9,7791,4,7452,5669,8069,1640,2752,38,63,105,157,2400,1112,25,52
some,,None,,1430,98,98% reported,edison,98%,19143,2020-11-04T10:43:59Z,R+57,Ernst +57,57.28751,republican,Osceola,8,,,8,3319,4,3259,2523,3529,656,1042,34,50,46,68,1006,386,16,22
unknown,,None,,4217,100,>98% reported,edison,>98%,19145,2020-11-04T10:44:00Z,R+42,Ernst +42,41.52417,republican,Page,9,,,8,7416,2,7427,5148,7773,2064,3549,77,121,138,201,2625,1485,44,63
unknown,,None,,2767,96,96% reported,edison,96%,19147,2020-11-07T22:49:51Z,R+29,Ernst +29,29.14216,republican,Palo Alto,6,,,5,5122,2,4931,3113,4642,1676,2848,36,52,106,156,1529,1172,16,50
all,,None,,7513,99,>98% reported,edison,>98%,19149,2020-11-04T10:44:01Z,R+47,Ernst +47,46.84195,republican,Plymouth,13,,,13,14157,6,13996,10128,15033,3572,6035,77,115,219,326,4905,2463,38,107
some,,None,,2023,91,91% reported,edison,91%,19151,2020-11-04T10:44:01Z,R+43,Ernst +43,43.42524,republican,Pocahontas,8,,,7,4139,4,3772,2640,3900,1002,1706,39,59,91,130,1260,704,20,39
some,,None,,139641,95,95% reported,edison,95%,19153,2020-11-04T10:44:01Z,D+14,Greenfield +14,14.01422,democrat,Polk,178,,,170,268604,4,255940,106391,145268,142259,239650,1980,3001,5310,7662,38877,97391,1021,2352
some,,None,,27049,100,>98% reported,edison,>98%,19155,2020-11-04T21:43:30Z,R+14,Ernst +14,13.7663,republican,Pottawattamie,26,,,26,44900,4,45023,24714,37042,18516,32253,524,845,1269,1932,12328,13737,321,663
all,,None,,6215,96,96% reported,edison,96%,19157,2020-11-04T10:44:03Z,R+10,Ernst +10,9.69479,republican,Poweshiek,4,,,4,10442,4,10026,5348,7964,4376,7835,91,136,211,306,2616,3459,45,95
some,,None,,1512,94,94% reported,edison,94%,19159,2020-11-04T10:44:04Z,R+42,Ernst +42,42.29911,republican,Ringgold,6,,,6,2848,4,2688,1867,2760,730,1302,16,24,75,114,893,572,8,39
unknown,,None,,2542,99,>98% reported,edison,>98%,19161,2020-11-04T10:44:05Z,R+44,Ernst +44,43.98682,republican,Sac,10,,,9,5543,2,5463,3839,5388,1436,2355,60,87,128,175,1549,919,27,47
unknown,,None,,62946,88,88% reported,edison,88%,19163,2020-11-04T10:44:06Z,D+3,Greenfield +3,3.05631,democrat,Scott,63,,,63,104315,2,91483,42921,67875,45717,82075,707,1155,2138,3324,24954,36358,448,1186
unknown,,None,,4211,98,98% reported,edison,98%,19165,2020-11-06T14:12:39Z,R+37,Ernst +37,37.36362,republican,Shelby,9,,,8,6801,2,6691,4489,7053,1989,3505,57,91,156,253,2564,1516,34,97
all,,None,,1785,100,>98% reported,edison,>98%,19167,2020-11-04T10:44:07Z,R+69,Ernst +69,68.60927,republican,Sioux,16,,,16,18943,6,18875,15776,17144,2826,3209,81,96,192,211,1368,383,15,19
unknown,,None,,29708,99,>98% reported,edison,>98%,19169,2020-11-04T10:44:08Z,D+15,Greenfield +15,14.79493,democrat,Story,43,,,37,50668,6,50105,20605,29036,28018,48571,368,578,1114,1628,8431,20553,210,514
all,,None,,3919,100,>98% reported,edison,>98%,19171,2020-11-04T10:44:08Z,R+17,Ernst +17,16.73925,republican,Tama,16,,,16,8998,6,8955,5085,6846,3586,5639,79,106,205,283,1761,2053,27,78
some,,None,,1949,100,>98% reported,edison,>98%,19173,2020-11-04T10:44:08Z,R+49,Ernst +49,49.11076,republican,Taylor,7,,,7,3130,4,3205,2334,3693,760,1284,28,47,83,130,1359,524,19,47
all,,None,,3604,99,>98% reported,edison,>98%,19175,2020-11-04T10:44:09Z,R+29,Ernst +29,29.03067,republican,Union,9,,,9,6149,6,6097,3811,5783,2041,3551,75,111,170,256,1972,1510,36,86
all,,None,,1470,100,>98% reported,edison,>98%,19177,2020-11-04T10:44:09Z,R+40,Ernst +40,40.4908,republican,Van Buren,9,,,9,3679,4,3749,2582,3425,1064,1653,28,38,75,103,843,589,10,28
unknown,,None,,8287,95,95% reported,edison,95%,19179,2020-11-04T10:44:09Z,R+14,Ernst +14,13.7886,republican,Wapello,22,,,19,16208,4,15317,8452,11929,6340,10919,132,199,393,557,3477,4579,67,164
some,,None,,17281,97,97% reported,edison,97%,19181,2020-11-04T10:44:09Z,R+16,Ernst +16,15.64879,republican,Warren,31,,,31,31668,4,30603,17234,24909,12445,21622,234,348,690,1005,7675,9177,114,315
all,,None,,6984,99,>98% reported,edison,>98%,19183,2020-11-04T10:44:10Z,R+19,Ernst +19,19.33517,republican,Washington,10,,,10,11757,6,11642,6768,10124,4517,7968,95,145,262,389,3356,3451,50,127
unknown,,None,,1579,100,>98% reported,edison,>98%,19185,2020-11-04T10:44:10Z,R+46,Ernst +46,45.95215,republican,Wayne,5,,,4,3037,2,3051,2186,3157,784,1347,28,46,53,80,971,563,18,27
some,,None,,9968,92,92% reported,edison,92%,19187,2020-11-04T10:44:10Z,R+19,Ernst +19,19.02029,republican,Webster,28,,,28,19161,4,17597,10184,14904,6837,11805,173,267,403,589,4720,4968,94,186
all,,None,,2903,100,>98% reported,edison,>98%,19189,2020-11-04T10:44:10Z,R+17,Ernst +17,16.52528,republican,Winnebago,11,,,10,2924,6,5894,3322,4596,2348,3891,71,106,153,204,1274,1543,35,51
unknown,,None,,8703,91,91% reported,edison,91%,19191,2020-11-04T10:44:11Z,R+4,Ernst +4,3.83135,republican,Winneshiek,11,,,10,13180,2,11954,6038,9765,5580,10351,118,195,218,346,3727,4771,77,128
unknown,,None,,26972,94,94% reported,edison,94%,19193,2020-11-04T10:44:11Z,R+12,Ernst +12,12.3514,republican,Woodbury,45,,,39,47039,2,44416,24141,36753,18655,32199,629,956,991,1480,12612,13544,327,489
unknown,,None,,1909,99,>98% reported,edison,>98%,19195,2020-11-04T10:44:11Z,R+14,Ernst +14,14.23333,republican,Worth,8,,,7,4398,2,4363,2420,3202,1799,2872,46,63,98,135,782,1073,17,37
unknown,,None,,3311,96,96% reported,edison,96%,19197,2020-11-04T10:44:12Z,R+30,Ernst +30,29.54398,republican,Wright,10,,,9,6463,2,6184,3889,5719,2062,3431,75,121,158,224,1830,1369,46,66
