absentee_count_progress,absentee_max_ballots,absentee_method,absentee_outstanding,absentee_votes,eevp,eevp_display,eevp_source,eevp_value,fips,last_updated,leader_margin_display,leader_margin_name_display,leader_margin_value,leader_party_id,name,precincts,provisional_count_progress,provisional_outstanding,reporting,tot_exp_vote,turnout_stage,votes,bidenj__total_count,democrat__total_count,hawkinsh__total_count,green__total_count,jorgensenj__total_count,libertarian__total_count,trumpd__total_count,republican__total_count,write-ins__total_count,bidenj__absentee_count,hawkinsh__absentee_count,jorgensenj__absentee_count,trumpd__absentee_count,write-ins__absentee_count
unknown,5645,Merged into voters' home precincts and released with cumulative results,,0,96,96% reported,edison,96%,39001,2020-11-04T10:43:43Z,R+63,Trump +63,63.25073,republican,Adams,21,,,19,12400,2,11905,2130,2130,26,26,89,89,9660,9660,0,0,0,0,0,0
unknown,21147,Merged into voters' home precincts and released with cumulative results,,0,95,95% reported,edison,95%,39003,2020-11-04T10:43:43Z,R+40,Trump +40,39.77611,republican,Allen,88,,,78,49000,2,46362,13611,13611,137,137,562,562,32052,32052,0,0,0,0,0,0
all,12763,Released as a separate subtotal as first report of the night,,16298,100,>98% reported,edison,>98%,39005,2020-11-04T10:43:44Z,R+49,Trump +49,48.50288,republican,Ashland,39,,,39,25883,6,25883,6448,11541,103,165,330,487,19002,29988,0,5093,62,157,10986,0
all,17976,Released as a separate subtotal as first report of the night,,23058,100,>98% reported,edison,>98%,39007,2020-11-04T10:43:44Z,R+23,Trump +23,23.1614,republican,Ashtabula,104,,,104,43253,6,43253,16207,27453,191,286,538,760,26225,37683,221,11246,95,222,11458,37
unknown,15184,Merged into voters' home precincts and released with cumulative results,,15706,100,>98% reported,edison,>98%,39009,2020-11-04T10:43:45Z,D+15,Biden +15,14.717,democrat,Athens,56,,,56,24809,6,24876,14047,25249,102,167,274,418,10386,14642,173,11202,65,144,4256,39
all,9630,"As a subtotal in the FIRST cumulative report, along with regular precincts",,0,100,>98% reported,edison,>98%,39011,2020-11-04T10:43:45Z,R+62,Trump +62,62.48228,republican,Auglaize,39,,,39,25396,6,25396,4583,4583,64,64,250,250,20451,20451,96,0,0,0,0,0
some,23979,Merged into voters' home precincts and released with cumulative results,,0,98,98% reported,edison,98%,39013,2020-11-04T10:43:45Z,R+43,Trump +43,43.29317,republican,Belmont,70,,,70,33243,4,32534,9007,9007,97,97,279,279,23092,23092,118,0,0,0,0,0
unknown,7776,Released as a separate subtotal as first report of the night,,0,100,>98% reported,edison,>98%,39015,2020-11-04T10:43:45Z,R+57,Trump +57,56.86389,republican,Brown,32,,,29,20326,2,20586,4326,4326,52,52,176,176,16032,16032,0,0,0,0,0,0
some,78506,Merged into voters' home precincts and released with cumulative results,,0,92,92% reported,edison,92%,39017,2020-11-04T10:43:46Z,R+24,Trump +24,24.16746,republican,Butler,282,,,259,198176,2,182034,67729,67729,476,476,2107,2107,111722,111722,0,0,0,0,0,0
all,5890,Released as a separate subtotal as first report of the night,,7672,100,>98% reported,edison,>98%,39019,2020-11-04T10:43:46Z,R+52,Trump +52,52.43964,republican,Carroll,23,,,22,13748,2,13957,3206,5552,54,86,150,217,10525,15741,55,2346,32,67,5216,11
all,9136,Released as a separate subtotal as first report of the night,,0,100,>98% reported,edison,>98%,39021,2020-11-04T10:43:46Z,R+47,Trump +47,47.18881,republican,Champaign,28,,,26,19369,6,19369,4946,4946,54,54,247,247,14086,14086,72,0,0,0,0,0
unknown,33222,Released as a separate subtotal as first report of the night,,40125,92,92% reported,edison,92%,39023,2020-11-04T10:43:47Z,R+23,Trump +23,23.2098,republican,Clark,90,,,81,67994,2,62870,23625,42340,239,392,789,1188,38217,59075,0,18715,153,399,20858,0
unknown,46664,Released as a separate subtotal as first report of the night,,0,96,96% reported,edison,96%,39025,2020-11-04T10:43:49Z,R+36,Trump +36,36.46147,republican,Clermont,166,,,164,112998,2,108531,33505,33505,265,265,1468,1468,73077,73077,432,0,0,0,0,0
unknown,8917,"As a subtotal in the FIRST cumulative report, along with regular precincts",,0,100,>98% reported,edison,>98%,39027,2020-11-04T10:43:50Z,R+53,Trump +53,52.68305,republican,Clinton,36,,,34,19796,2,19940,4556,4556,64,64,259,259,15061,15061,0,0,0,0,0,0
all,16355,Merged into voters' home precincts and released with cumulative results,,22098,100,>98% reported,edison,>98%,39029,2020-11-04T10:43:51Z,R+45,Trump +45,44.62364,republican,Columbiana,87,,,87,49169,6,49169,13183,21838,158,242,597,804,35124,48220,270,8655,84,207,13096,56
all,9803,Released as a separate subtotal as first report of the night,,11108,100,>98% reported,edison,>98%,39031,2020-11-04T10:43:51Z,R+48,Trump +48,48.47688,republican,Coshocton,23,,,23,16348,6,16348,4057,7409,59,103,221,367,11982,19531,75,3352,44,146,7549,17
all,10312,Merged into voters' home precincts and released with cumulative results,,0,100,>98% reported,edison,>98%,39033,2020-11-04T10:43:52Z,R+50,Trump +50,50.49946,republican,Crawford,35,,,35,20192,6,20222,4831,4831,50,50,268,268,15043,15043,60,0,0,0,0,0
all,431608,Released as a separate subtotal as first report of the night,,586535,82,82% reported,edison,82%,39035,2020-11-04T10:43:52Z,D+34,Biden +34,34.23707,democrat,Cuyahoga,975,,,855,734525,4,605268,402315,792437,1914,3758,4403,8649,195089,383865,4641,390122,1844,4246,188776,1547
unknown,10557,Merged into voters' home precincts and released with cumulative results,,0,100,>98% reported,edison,>98%,39037,2020-11-04T10:43:52Z,R+63,Trump +63,63.48747,republican,Darke,43,,,39,26418,2,26621,4668,4668,60,60,324,324,21569,21569,0,0,0,0,0,0
unknown,9581,Merged into voters' home precincts and released with cumulative results,,13089,99,>98% reported,edison,>98%,39039,2020-11-04T10:43:53Z,R+36,Trump +36,36.29676,republican,Defiance,33,,,33,19261,4,19032,5870,10709,77,125,264,401,12778,20820,109,4839,48,137,8042,23
unknown,62675,Released as a separate subtotal as first report of the night,,0,100,>98% reported,edison,>98%,39041,2020-11-04T10:43:53Z,R+7,Trump +7,6.6143,republican,Delaware,165,,,165,109108,2,124004,56961,56961,287,287,1593,1593,65163,65163,0,0,0,0,0,0
unknown,22709,Released as a separate subtotal as first report of the night,,0,88,88% reported,edison,88%,39043,2020-11-04T10:43:53Z,R+12,Trump +12,11.59325,republican,Erie,62,,,57,44922,2,39523,17142,17142,152,152,505,505,21724,21724,0,0,0,0,0,0
all,43430,Merged into voters' home precincts and released with cumulative results,,54829,98,98% reported,edison,98%,39045,2020-11-04T10:43:54Z,R+23,Trump +23,23.38493,republican,Fairfield,107,,,105,83121,2,81591,30634,54751,218,351,998,1537,49714,79727,81,24117,133,539,30013,27
all,5552,Released as a separate subtotal as first report of the night,,7133,100,>98% reported,edison,>98%,39047,2020-11-04T10:43:54Z,R+51,Trump +51,51.27184,republican,Fayette,25,,,25,12305,6,12305,2911,5051,32,49,129,182,9220,14136,33,2140,17,53,4916,7
unknown,374078,Released as a separate subtotal as first report of the night,,0,91,91% reported,edison,91%,39049,2020-11-04T10:43:55Z,D+31,Biden +31,31.09293,democrat,Franklin,884,,,806,662500,4,606022,391584,391584,2026,2026,7294,7294,203154,203154,3928,0,0,0,0,0
some,8866,Released as a separate subtotal as first report of the night,,0,100,>98% reported,edison,>98%,39051,2020-11-04T10:43:56Z,R+40,Trump +40,39.69236,republican,Fulton,29,,,27,22401,2,22299,6545,6545,68,68,290,290,15396,15396,0,0,0,0,0,0
unknown,5408,Released as a separate subtotal as first report of the night,,0,98,98% reported,edison,98%,39053,2020-11-04T10:43:57Z,R+55,Trump +55,55.23282,republican,Gallia,26,,,24,13619,2,13358,2911,2911,32,32,126,126,10289,10289,0,0,0,0,0,0
unknown,25718,Other,,0,100,>98% reported,edison,>98%,39055,2020-11-04T10:43:58Z,R+23,Trump +23,22.75329,republican,Geauga,78,,,78,55381,6,55381,20980,20980,132,132,524,524,33581,33581,328,0,0,0,0,0
unknown,43531,Other,,0,99,>98% reported,edison,>98%,39057,2020-11-04T10:43:59Z,R+20,Trump +20,19.52757,republican,Greene,146,,,136,87708,2,86616,34023,34023,258,258,1398,1398,50937,50937,0,0,0,0,0,0
unknown,8078,Merged into voters' home precincts and released with cumulative results,,0,100,>98% reported,edison,>98%,39059,2020-11-04T10:43:59Z,R+48,Trump +48,48.18039,republican,Guernsey,35,,,33,17430,2,17806,4498,4498,61,61,170,170,13077,13077,0,0,0,0,0,0
unknown,183454,Released as a separate subtotal as first report of the night,,245471,87,87% reported,edison,87%,39061,2020-11-04T10:43:59Z,D+16,Biden +16,15.5867,democrat,Hamilton,563,,,560,477539,4,417574,238101,407644,1303,1967,4989,7150,173015,246015,435,169543,664,2161,73000,103
unknown,19219,Merged into voters' home precincts and released with cumulative results,,0,93,93% reported,edison,93%,39063,2020-11-04T10:44:00Z,R+38,Trump +38,37.52993,republican,Hancock,60,,,56,41066,2,37999,11535,11535,103,103,565,565,25796,25796,0,0,0,0,0,0
unknown,6294,Other,,0,99,>98% reported,edison,>98%,39065,2020-11-04T10:44:00Z,R+52,Trump +52,51.51305,republican,Hardin,21,,,19,13111,2,12954,3025,3025,43,43,188,188,9698,9698,0,0,0,0,0,0
unknown,3522,Merged into voters' home precincts and released with cumulative results,,0,100,>98% reported,edison,>98%,39067,2020-11-04T10:40:27Z,R+52,Trump +52,52.34667,republican,Harrison,16,,,15,7403,2,7500,1742,1742,34,34,56,56,5668,5668,0,0,0,0,0,0
unknown,7016,Merged into voters' home precincts and released with cumulative results,,0,96,96% reported,edison,96%,39069,2020-11-04T10:44:01Z,R+43,Trump +43,43.35037,republican,Henry,23,,,21,15090,2,14482,3995,3995,43,43,171,171,10273,10273,0,0,0,0,0,0
some,8226,Released as a separate subtotal as first report of the night,,10178,100,>98% reported,edison,>98%,39071,2020-11-04T10:44:01Z,R+60,Trump +60,60.23934,republican,Highland,31,,,31,19303,6,19303,3741,6453,49,77,140,180,15369,22766,9,2712,28,40,7397,1
some,7512,Released as a separate subtotal as first report of the night,,9874,100,>98% reported,edison,>98%,39073,2020-11-04T10:44:01Z,R+41,Trump +41,41.47686,republican,Hocking,21,,,21,13521,2,13786,3836,7081,40,68,160,266,9554,16019,422,3245,28,106,6465,30
unknown,6416,Released as a separate subtotal as first report of the night,,7977,100,>98% reported,edison,>98%,39075,2020-11-04T10:44:02Z,R+68,Trump +68,67.63994,republican,Holmes,17,,,17,11959,4,12809,1981,3586,26,46,120,189,10645,16904,98,1605,20,69,6259,24
all,12338,Released as a separate subtotal as first report of the night,,0,100,>98% reported,edison,>98%,39077,2020-11-04T10:44:02Z,R+41,Trump +41,40.91182,republican,Huron,46,,,46,26628,6,26628,7643,7643,81,81,367,367,18537,18537,0,0,0,0,0,0
all,7259,Other,,0,100,>98% reported,edison,>98%,39079,2020-11-04T10:44:02Z,R+54,Trump +54,53.75,republican,Jackson,30,,,30,14160,6,14160,3193,3193,29,29,134,134,10804,10804,0,0,0,0,0,0
unknown,16200,Merged into voters' home precincts and released with cumulative results,,0,94,94% reported,edison,94%,39081,2020-11-04T10:44:02Z,R+38,Trump +38,38.33354,republican,Jefferson,71,,,63,34830,2,32572,9823,9823,97,97,343,343,22309,22309,0,0,0,0,0,0
unknown,17702,Released as a separate subtotal as first report of the night,,0,100,>98% reported,edison,>98%,39083,2020-11-04T10:43:27Z,R+44,Trump +44,43.61789,republican,Knox,53,,,50,30409,2,30703,8433,8433,82,82,363,363,21825,21825,0,0,0,0,0,0
unknown,65162,Other,,82427,95,95% reported,edison,95%,39085,2020-11-04T10:43:28Z,R+14,Trump +14,13.51248,republican,Lake,163,,,163,134979,4,127867,54337,96432,385,616,1240,1861,71615,110926,749,42095,231,621,39311,169
unknown,11954,Merged into voters' home precincts and released with cumulative results,,0,99,>98% reported,edison,>98%,39087,2020-11-04T10:43:28Z,R+45,Trump +45,45.2328,republican,Lawrence,84,,,76,27582,2,27427,7353,7353,68,68,247,247,19759,19759,0,0,0,0,0,0
unknown,45584,Released as a separate subtotal as first report of the night,,0,97,97% reported,edison,97%,39089,2020-11-04T10:43:28Z,R+28,Trump +28,27.92225,republican,Licking,96,,,93,94348,2,91830,32324,32324,301,301,1240,1240,57965,57965,0,0,0,0,0,0
all,10603,Released as a separate subtotal as first report of the night,,0,100,>98% reported,edison,>98%,39091,2020-11-04T10:43:28Z,R+55,Trump +55,54.97063,republican,Logan,36,,,36,22719,4,22985,4990,4990,67,67,257,257,17625,17625,92,0,0,0,0,0
unknown,81890,Merged into voters' home precincts and released with cumulative results,,0,93,93% reported,edison,93%,39093,2020-11-04T10:43:28Z,R+3,Trump +3,2.58376,republican,Lorain,193,,,193,163307,4,151988,72792,72792,504,504,1615,1615,76719,76719,716,0,0,0,0,0
unknown,101640,Released as a separate subtotal as first report of the night,,0,81,81% reported,edison,81%,39095,2020-11-04T10:43:29Z,D+17,Biden +17,16.60543,democrat,Lucas,312,,,270,239647,2,194882,111989,111989,757,757,2508,2508,79628,79628,0,0,0,0,0,0
unknown,9619,Merged into voters' home precincts and released with cumulative results,,0,100,>98% reported,edison,>98%,39097,2020-11-04T10:43:29Z,R+41,Trump +41,40.84624,republican,Madison,24,,,24,18449,2,19309,5558,5558,46,46,260,260,13445,13445,0,0,0,0,0,0
some,67570,Released as a separate subtotal as first report of the night,,67924,100,>98% reported,edison,>98%,39099,2020-11-04T10:43:29Z,R+1.9,Trump +1.9,1.93454,republican,Mahoning,212,,,212,116565,6,116565,56346,98388,425,652,956,1354,58601,83734,598,42042,227,398,25133,124
unknown,12346,Released as a separate subtotal as first report of the night,,0,100,>98% reported,edison,>98%,39101,2020-11-04T10:43:30Z,R+38,Trump +38,38.476,republican,Marion,65,,,59,27126,6,27126,8089,8089,108,108,403,403,18526,18526,0,0,0,0,0,0
all,52920,Released as a separate subtotal as first report of the night,,64128,100,>98% reported,edison,>98%,39103,2020-11-04T10:43:31Z,R+23,Trump +23,23.11311,republican,Medina,121,,,121,104378,6,104378,39326,69696,261,409,1109,1660,63451,96394,578,30370,148,551,32943,116
all,4038,Released as a separate subtotal as first report of the night,,6387,100,>98% reported,edison,>98%,39105,2020-11-04T10:43:32Z,R+53,Trump +53,53.05648,republican,Meigs,27,,,27,10764,6,10764,2452,4310,32,52,108,156,8163,12623,19,1858,20,48,4460,1
all,12162,Released as a separate subtotal as first report of the night,,15454,100,>98% reported,edison,>98%,39107,2020-11-04T10:43:34Z,R+65,Trump +65,64.73149,republican,Mercer,36,,,36,23426,6,23426,3981,7315,67,107,202,319,19145,31086,84,3334,40,117,11941,22
unknown,27334,Merged into voters' home precincts and released with cumulative results,,36421,100,>98% reported,edison,>98%,39109,2020-11-04T10:43:35Z,R+44,Trump +44,44.07913,republican,Miami,85,,,85,55899,4,56968,15420,27803,138,220,762,1160,40531,64021,302,12383,82,398,23490,68
unknown,3733,Released as a precinct as first report of the night,,0,100,>98% reported,edison,>98%,39111,2020-11-04T10:43:35Z,R+54,Trump +54,53.7079,republican,Monroe,20,,,18,7044,2,7066,1597,1597,26,26,51,51,5392,5392,0,0,0,0,0,0
all,127390,Released as a precinct as first report of the night,,154810,86,86% reported,edison,86%,39113,2020-11-04T10:43:36Z,D+2,Biden +2,2.09743,democrat,Montgomery,360,,,360,303557,4,262560,131592,229656,857,1326,3315,4727,126085,180626,1746,98064,469,1412,54541,324
unknown,3651,Merged into voters' home precincts and released with cumulative results,,0,100,>98% reported,edison,>98%,39115,2020-11-04T10:43:36Z,R+48,Trump +48,48.04345,republican,Morgan,13,,,12,6679,2,6721,1703,1703,16,16,61,61,4932,4932,18,0,0,0,0,0
all,7283,Merged into voters' home precincts and released with cumulative results,,0,100,>98% reported,edison,>98%,39117,2020-11-04T10:43:36Z,R+54,Trump +54,54.15745,republican,Morrow,33,,,32,17155,4,18088,3988,3988,68,68,248,248,13784,13784,0,0,0,0,0,0
unknown,22390,Merged into voters' home precincts and released with cumulative results,,0,100,>98% reported,edison,>98%,39119,2020-11-04T10:43:37Z,R+39,Trump +39,39.24873,republican,Muskingum,68,,,64,39059,2,39693,11755,11755,153,153,451,451,27334,27334,0,0,0,0,0,0
unknown,3920,None,,0,100,>98% reported,edison,>98%,39121,2020-11-04T10:43:37Z,R+62,Trump +62,62.1765,republican,Noble,19,,,19,6234,4,6221,1156,1156,13,13,23,23,5024,5024,10,0,0,0,0,0
unknown,11056,Merged into voters' home precincts and released with cumulative results,,0,99,>98% reported,edison,>98%,39123,2020-11-04T10:43:37Z,R+23,Trump +23,23.11583,republican,Ottawa,36,,,36,23803,4,23525,8847,8847,70,70,281,281,14285,14285,84,0,0,0,0,0
all,4563,Merged into voters' home precincts and released with cumulative results,,5745,100,>98% reported,edison,>98%,39125,2020-11-04T10:43:38Z,R+51,Trump +51,51.23922,republican,Paulding,16,,,16,9280,6,9280,2172,3837,37,58,121,177,6927,10920,56,1665,21,56,3993,10
some,7278,Merged into voters' home precincts and released with cumulative results,,9445,100,>98% reported,edison,>98%,39127,2020-11-04T10:43:39Z,R+49,Trump +49,49.15631,republican,Perry,33,,,33,15544,4,16179,4006,7024,46,74,165,240,11959,18283,6,3018,28,75,6324,0
some,12064,Other,,0,100,>98% reported,edison,>98%,39129,2020-11-04T10:43:40Z,R+47,Trump +47,46.65943,republican,Pickaway,42,,,42,26230,4,27630,7167,7167,64,64,286,286,20059,20059,108,0,0,0,0,0
unknown,6190,Merged into voters' home precincts and released with cumulative results,,0,98,98% reported,edison,98%,39131,2020-11-04T10:43:41Z,R+48,Trump +48,48.25499,republican,Pike,22,,,20,12314,2,12063,3051,3051,22,22,118,118,8872,8872,0,0,0,0,0,0
all,35339,Other,,31467,100,>98% reported,edison,>98%,39133,2020-11-04T10:43:43Z,R+12,Trump +12,12.42495,republican,Portage,129,,,129,80092,4,81280,34935,54185,284,418,863,1168,45034,56720,420,19250,134,305,11686,92
unknown,7200,Merged into voters' home precincts and released with cumulative results,,4381,100,>98% reported,edison,>98%,39135,2020-11-04T10:43:43Z,R+57,Trump +57,57.20017,republican,Preble,42,,,42,21422,6,21437,4435,6197,50,65,240,287,16697,19254,30,1762,15,47,2557,0
unknown,8054,Merged into voters' home precincts AFTER election night,,0,99,>98% reported,edison,>98%,39137,2020-11-04T10:43:44Z,R+66,Trump +66,66.42265,republican,Putnam,25,,,23,19893,2,19671,3152,3152,60,60,241,241,16218,16218,0,0,0,0,0,0
all,32970,Merged into voters' home precincts and released with cumulative results,,37772,96,96% reported,edison,96%,39139,2020-11-04T10:43:44Z,R+40,Trump +40,39.76553,republican,Richland,83,,,83,61176,4,58601,17231,30901,163,265,659,973,40534,64214,34,13670,102,314,23680,6
unknown,17573,Merged into voters' home precincts and released with cumulative results,,0,100,>98% reported,edison,>98%,39141,2020-11-04T10:43:44Z,R+35,Trump +35,34.86521,republican,Ross,65,,,65,31997,4,32531,10345,10345,106,106,328,328,21687,21687,130,0,0,0,0,0
unknown,11870,Released as a separate subtotal as first report of the night,,0,97,97% reported,edison,97%,39143,2020-11-04T10:43:45Z,R+27,Trump +27,27.45337,republican,Sandusky,58,,,58,30535,4,29490,10391,10391,128,128,430,430,18487,18487,108,0,0,0,0,0
unknown,15107,Released as a precinct as first report of the night,,0,95,95% reported,edison,95%,39145,2020-11-04T10:43:45Z,R+42,Trump +42,41.89944,republican,Scioto,77,,,68,32820,2,31146,8876,8876,87,87,257,257,21926,21926,0,0,0,0,0,0
unknown,9734,Merged into voters' home precincts and released with cumulative results,,0,95,95% reported,edison,95%,39147,2020-11-04T10:43:45Z,R+34,Trump +34,33.93097,republican,Seneca,51,,,47,26607,2,25322,8147,8147,91,91,345,345,16739,16739,0,0,0,0,0,0
all,11214,Merged into voters' home precincts and released with cumulative results,,14476,100,>98% reported,edison,>98%,39149,2020-11-04T10:43:46Z,R+63,Trump +63,62.89691,republican,Shelby,35,,,35,24785,6,24785,4399,7946,70,117,284,436,19988,30718,88,3547,47,152,10730,0
unknown,83515,Merged into voters' home precincts and released with cumulative results,,0,90,90% reported,edison,90%,39151,2020-11-04T10:43:46Z,R+18,Trump +18,18.45526,republican,Stark,274,,,255,206880,2,185714,74336,74336,669,669,2099,2099,108610,108610,0,0,0,0,0,0
unknown,138795,None,,149489,90,90% reported,edison,90%,39153,2020-11-04T10:43:46Z,D+10,Biden +10,9.50911,democrat,Summit,420,,,418,305188,2,274768,148151,250370,836,1239,2905,4054,122023,167321,2126,102219,403,1149,45298,420
some,47683,Released as a separate subtotal as first report of the night,,89258,100,>98% reported,edison,>98%,39155,2020-11-04T10:43:47Z,R+10,Trump +10,10.35905,republican,Trumbull,158,,,158,98677,6,98677,43534,85355,345,650,877,1664,53756,99949,482,41821,305,787,46193,152
some,22667,Merged into voters' home precincts and released with cumulative results,,0,98,98% reported,edison,98%,39157,2020-11-04T10:43:48Z,R+39,Trump +39,39.41149,republican,Tuscarawas,81,,,81,43828,4,42820,12643,12643,154,154,469,469,29519,29519,70,0,0,0,0,0
unknown,14723,Merged into voters' home precincts and released with cumulative results,,0,97,97% reported,edison,97%,39159,2020-11-04T10:43:50Z,R+31,Trump +31,31.20775,republican,Union,45,,,45,34000,2,32838,10985,10985,98,98,522,522,21233,21233,0,0,0,0,0,0
some,9334,Merged into voters' home precincts and released with cumulative results,,0,100,>98% reported,edison,>98%,39161,2020-11-04T10:43:50Z,R+57,Trump +57,57.18155,republican,Van Wert,39,,,39,14767,6,14767,3026,3026,42,42,195,195,11470,11470,68,0,0,0,0,0
all,3106,Merged into voters' home precincts and released with cumulative results,,0,100,>98% reported,edison,>98%,39163,2020-11-04T10:43:51Z,R+55,Trump +55,54.54083,republican,Vinton,20,,,20,5902,6,5902,1306,1306,15,15,45,45,4525,4525,22,0,0,0,0,0
unknown,59072,Merged into voters' home precincts and released with cumulative results,,89102,100,>98% reported,edison,>98%,39165,2020-11-04T10:43:51Z,R+30,Trump +30,30.23544,republican,Warren,175,,,175,132061,6,132391,45040,81984,280,439,1672,2593,85069,135929,878,36944,159,921,50860,218
all,15685,Released as a precinct as first report of the night,,17392,99,>98% reported,edison,>98%,39167,2020-11-04T10:43:52Z,R+40,Trump +40,40.41807,republican,Washington,50,,,46,31631,2,31382,9114,15782,107,168,363,535,21798,32289,0,6668,61,172,10491,0
all,24814,Merged into voters' home precincts and released with cumulative results,,58342,100,>98% reported,edison,>98%,39169,2020-11-04T10:43:52Z,R+16,Trump +16,16.41699,republican,Wayne,67,,,34,58342,6,58342,24040,48080,182,364,502,1004,33618,67236,0,24040,182,502,33618,0
unknown,7416,Released as a separate subtotal as first report of the night,,0,100,>98% reported,edison,>98%,39171,2020-11-04T10:43:53Z,R+46,Trump +46,46.42974,republican,Williams,26,,,24,18290,6,18290,4726,4726,68,68,278,278,13218,13218,0,0,0,0,0,0
unknown,29603,Merged into voters' home precincts and released with cumulative results,,0,97,97% reported,edison,97%,39173,2020-11-04T10:43:53Z,R+8,Trump +8,7.61919,republican,Wood,95,,,95,67593,4,65860,29797,29797,205,205,969,969,34815,34815,148,0,0,0,0,0
unknown,4205,Merged into voters' home precincts and released with cumulative results,,0,100,>98% reported,edison,>98%,39175,2020-11-04T10:43:53Z,R+50,Trump +50,49.97303,republican,Wyandot,23,,,21,11156,2,11122,2690,2690,37,37,147,147,8248,8248,0,0,0,0,0,0
