absentee_count_progress,absentee_max_ballots,absentee_method,absentee_outstanding,absentee_votes,eevp,eevp_display,eevp_source,eevp_value,fips,last_updated,leader_margin_display,leader_margin_name_display,leader_margin_value,leader_party_id,name,precincts,provisional_count_progress,provisional_outstanding,reporting,tot_exp_vote,turnout_stage,votes,collinsda__total_count,green__total_count,cornynj__total_count,republican__total_count,hegarm__total_count,democrat__total_count,mckennonk__total_count,libertarian__total_count,write-ins__total_count,collinsda__absentee_count,cornynj__absentee_count,hegarm__absentee_count,mckennonk__absentee_count,write-ins__absentee_count
none,15380.0,Released as a precinct as first report of the night,,14361,95,95% reported,edison,95%,48001,2020-11-04T10:43:50Z,R+59,Cornyn +59,58.52581,republican,Anderson,23,,,20,20048,2,19007,88,155,14897,25933,3773,6862,245,413,9,67,11036,3089,168,1
unknown,4805.0,Released as a precinct as first report of the night,,4734,98,98% reported,edison,98%,48003,2020-11-04T10:43:51Z,R+74,Cornyn +74,73.91992,republican,Andrews,5,,,4,5837,2,5694,20,34,4888,8893,679,1321,107,180,0,14,4005,642,73,0
unknown,28954.0,Released as a precinct as first report of the night,,28462,97,97% reported,edison,97%,48005,2020-11-04T10:43:52Z,R+47,Cornyn +47,47.12286,republican,Angelina,43,,,38,35322,2,34357,160,278,24955,45594,8765,16126,460,795,43,118,20639,7361,335,9
unknown,10783.0,Released as a precinct as first report of the night,,10900,98,98% reported,edison,98%,48007,2020-11-04T10:43:53Z,R+53,Cornyn +53,53.23539,republican,Aransas,6,,,5,12414,2,12116,67,121,9161,17388,2711,5190,177,317,0,54,8227,2479,140,0
unknown,2737.0,Released as a precinct as first report of the night,,3581,89,89% reported,edison,89%,48009,2020-11-04T10:43:53Z,R+79,Cornyn +79,78.55631,republican,Archer,12,,,10,5288,2,4724,14,27,4178,7343,467,835,65,100,0,13,3165,368,35,0
unknown,777.0,Released as a precinct as first report of the night,,842,88,88% reported,edison,88%,48011,2020-11-04T10:43:54Z,R+87,Cornyn +87,86.88969,republican,Armstrong,8,,,7,1260,2,1106,5,9,1025,1804,64,115,12,20,0,4,779,51,8,0
unknown,10647.0,Released as a precinct as first report of the night,,14598,100,>98% reported,edison,>98%,48013,2020-11-04T10:43:56Z,R+35,Cornyn +35,35.33923,republican,Atascosa,25,,,25,17775,2,17864,142,229,11889,21623,5576,10165,257,445,0,87,9734,4589,188,0
some,9966.0,Released as a precinct as first report of the night,,11500,94,94% reported,edison,94%,48015,2020-11-04T10:43:57Z,R+60,Cornyn +60,59.88669,republican,Austin,18,,,16,15153,2,14297,57,95,11294,20341,2732,4992,211,364,8,38,9047,2260,153,2
unknown,1464.0,Released as a precinct as first report of the night,,1266,77,77% reported,edison,77%,48017,2020-11-04T10:43:59Z,R+56,Cornyn +56,55.80627,republican,Bailey,5,,,4,2361,2,1817,11,16,1396,2412,382,615,28,40,0,5,1016,233,12,0
unknown,10011.0,Released as a precinct as first report of the night,,10936,99,>98% reported,edison,>98%,48019,2020-11-04T10:43:59Z,R+61,Cornyn +61,61.1253,republican,Bandera,11,,,10,12614,2,12530,55,92,9950,18569,2291,4392,234,413,0,37,8619,2101,179,0
unknown,25791.0,Released as a precinct as first report of the night,,31199,100,>98% reported,edison,>98%,48021,2020-11-04T10:44:00Z,R+15,Cornyn +15,14.78232,republican,Bastrop,23,,,23,33601,2,36476,208,364,20439,37414,15047,28552,757,1318,52,156,16975,13505,561,2
unknown,1554.0,Released as a precinct as first report of the night,,1355,88,88% reported,edison,88%,48023,2020-11-04T10:44:01Z,R+77,Cornyn +77,76.73297,republican,Baylor,5,,,4,1880,2,1659,8,12,1447,2643,174,311,29,47,2,4,1196,137,18,0
unknown,7301.0,Released as a precinct as first report of the night,,7265,90,90% reported,edison,90%,48025,2020-11-04T10:44:01Z,R+29,Cornyn +29,28.91273,republican,Bee,18,,,15,10020,2,9041,58,100,5708,10228,3094,5666,171,297,25,42,4520,2572,126,5
unknown,89466.0,Released as a precinct as first report of the night,,102529,100,>98% reported,edison,>98%,48027,2020-11-04T10:44:02Z,R+12,Cornyn +12,11.69179,republican,Bell,49,,,49,117276,4,125122,719,1239,68118,122542,53489,99230,2687,4527,222,520,54424,45741,1840,4
all,609654.0,Released as a precinct as first report of the night,,660833,97,97% reported,edison,97%,48029,2020-11-04T10:44:02Z,D+12,Hegar +12,12.086,democrat,Bexar,767,,,741,766539,2,741238,6186,11014,314896,592630,404482,770260,14896,26690,2255,4828,277734,365778,11794,699
unknown,4204.0,Released as a precinct as first report of the night,,6408,100,>98% reported,edison,>98%,48031,2020-11-04T10:44:05Z,R+49,Cornyn +49,49.10026,republican,Blanco,7,,,7,7019,2,7391,30,52,5441,10076,1812,3479,103,184,13,22,4635,1667,81,3
unknown,320.0,Released as a precinct as first report of the night,,302,86,86% reported,edison,86%,48033,2020-11-04T10:44:07Z,R+91,Cornyn +91,91.15479,republican,Borden,8,,,7,475,2,407,2,3,388,678,17,28,0,0,0,1,290,11,0,0
unknown,4229.0,Released as a precinct as first report of the night,,6473,97,97% reported,edison,97%,48035,2020-11-04T10:44:07Z,R+65,Cornyn +65,65.04553,republican,Bosque,12,,,11,9256,2,9006,60,98,7341,12569,1483,2613,121,198,2,38,5228,1130,77,0
all,32487.0,Released as a precinct as first report of the night,,29818,91,91% reported,edison,91%,48037,2020-11-04T10:44:08Z,R+44,Cornyn +44,43.59448,republican,Bowie,43,,,36,41804,4,37858,142,238,26848,47425,10344,19116,471,807,143,96,20577,8772,336,37
some,131649.0,Released as a precinct as first report of the night,,138192,100,>98% reported,edison,>98%,48039,2020-11-04T10:44:09Z,R+21,Cornyn +21,20.91356,republican,Brazoria,67,,,65,149605,2,152437,875,1609,90214,171665,58334,111890,3009,5456,14,734,81451,53556,2447,4
all,57474.0,Released as a precinct as first report of the night,,71230,99,>98% reported,edison,>98%,48041,2020-11-04T10:44:09Z,R+21,Cornyn +21,20.56113,republican,Brazos,99,,,95,84753,6,83974,459,796,49271,90701,32005,59833,2239,3874,0,337,41430,27828,1635,0
unknown,4467.0,Released as a precinct as first report of the night,,3947,99,>98% reported,edison,>98%,48043,2020-11-04T10:44:09Z,R+6,Cornyn +6,6.02815,republican,Brewster,9,,,8,4805,6,4761,35,59,2447,4433,2160,4018,113,190,14,24,1986,1858,77,2
unknown,503.0,Released as a precinct as first report of the night,,448,75,75% reported,edison,75%,48045,2020-11-04T10:44:10Z,R+77,Cornyn +77,76.61064,republican,Briscoe,6,,,4,957,2,714,5,7,625,1017,78,130,6,8,0,2,392,52,2,0
unknown,1853.0,Released as a precinct as first report of the night,,1745,70,70% reported,edison,70%,48047,2020-11-04T10:44:10Z,D+24,Hegar +24,24.02377,democrat,Brooks,6,,,4,3375,2,2356,33,51,859,1425,1425,2555,39,70,0,18,566,1130,31,0
some,14372.0,Released as a precinct as first report of the night,,12376,95,95% reported,edison,95%,48049,2020-11-04T10:44:10Z,R+73,Cornyn +73,73.1312,republican,Brown,19,,,16,16564,2,15732,58,101,13465,24047,1960,3537,249,423,0,43,10582,1577,174,0
unknown,5572.0,Released as a precinct as first report of the night,,6592,100,>98% reported,edison,>98%,48051,2020-11-04T10:44:11Z,R+58,Cornyn +58,57.57219,republican,Burleson,14,,,13,8219,2,8485,42,68,6593,11669,1708,3101,142,239,0,26,5076,1393,97,0
unknown,17630.0,Released as a precinct as first report of the night,,20701,100,>98% reported,edison,>98%,48053,2020-11-04T10:44:11Z,R+55,Cornyn +55,54.53245,republican,Burnet,21,,,21,23708,2,24468,91,149,18642,34308,5299,9958,436,754,0,58,15666,4659,318,0
unknown,10580.0,Released as a precinct as first report of the night,,12256,100,>98% reported,edison,>98%,48055,2020-11-04T10:44:11Z,R+11,Cornyn +11,11.23825,republican,Caldwell,32,,,30,14280,2,14682,100,176,7975,14579,6325,11694,270,469,32,76,6604,5369,199,8
unknown,5674.0,Released as a precinct as first report of the night,,5621,94,94% reported,edison,94%,48057,2020-11-04T10:44:12Z,R+44,Cornyn +44,44.45162,republican,Calhoun,26,,,22,8225,2,7741,22,34,5530,9377,2089,3790,100,161,0,12,3847,1701,61,0
unknown,4184.0,Released as a precinct as first report of the night,,5411,100,>98% reported,edison,>98%,48059,2020-11-04T10:44:13Z,R+78,Cornyn +78,77.57413,republican,Callahan,8,,,7,6589,2,6711,39,64,5886,10631,680,1244,106,183,0,25,4745,564,77,0
some,71585.0,Released as a precinct as first report of the night,,93582,93,93% reported,edison,93%,48061,2020-11-04T10:48:07Z,D+13,Hegar +13,13.46631,democrat,Cameron,104,,,96,119703,4,110743,1427,2458,46289,85243,61202,113414,1789,3150,96,1031,38954,52212,1361,24
unknown,4295.0,Released as a precinct as first report of the night,,4279,94,94% reported,edison,94%,48063,2020-11-04T10:44:13Z,R+44,Cornyn +44,44.49742,republican,Camp,5,,,4,5364,2,5034,22,36,3597,6703,1357,2480,57,93,2,14,3106,1123,36,0
unknown,1767.0,Released as a precinct as first report of the night,,1892,84,84% reported,edison,84%,48065,2020-11-04T10:44:14Z,R+80,Cornyn +80,79.60312,republican,Carson,9,,,7,3659,2,3074,5,6,2725,4382,278,482,63,91,8,1,1657,204,28,2
unknown,8478.0,Released as a precinct as first report of the night,,10581,93,93% reported,edison,93%,48067,2020-11-04T10:44:14Z,R+59,Cornyn +59,59.46641,republican,Cass,19,,,16,14577,2,13606,52,86,10746,19040,2655,4809,153,252,0,34,8294,2154,99,0
unknown,1417.0,Released as a precinct as first report of the night,,1103,74,74% reported,edison,74%,48069,2020-11-04T10:44:15Z,R+56,Cornyn +56,55.83333,republican,Castro,9,,,7,2755,2,2040,13,19,1571,2416,432,676,24,32,0,6,845,244,8,0
some,17808.0,Released as a precinct as first report of the night,,18832,100,>98% reported,edison,>98%,48071,2020-11-04T10:44:15Z,R+62,Cornyn +62,62.04198,republican,Chambers,15,,,15,19823,2,21342,111,199,17027,32191,3786,7036,418,748,0,88,15164,3250,330,0
unknown,16073.0,Released as a precinct as first report of the night,,15337,97,97% reported,edison,97%,48073,2020-11-04T10:44:15Z,R+56,Cornyn +56,56.33299,republican,Cherokee,25,,,22,19827,2,19280,59,101,14907,26649,4046,7405,268,462,0,42,11742,3359,194,0
unknown,1817.0,Released as a precinct as first report of the night,,1776,91,91% reported,edison,91%,48075,2020-11-04T10:44:15Z,R+73,Cornyn +73,73.20232,republican,Childress,5,,,4,2461,2,2239,11,20,1919,3450,280,497,29,48,0,9,1531,217,19,0
unknown,3005.0,Released as a precinct as first report of the night,,4133,95,95% reported,edison,95%,48077,2020-11-04T10:44:16Z,R+76,Cornyn +76,75.92202,republican,Clay,17,,,15,5971,2,5694,27,43,4955,8543,632,1106,69,114,32,16,3588,474,45,10
unknown,604.0,Released as a precinct as first report of the night,,662,82,82% reported,edison,82%,48079,2020-11-04T10:44:16Z,R+59,Cornyn +59,59.28205,republican,Cochran,4,,,3,1192,2,975,8,13,761,1282,183,308,22,32,3,5,521,125,10,1
unknown,1206.0,Released as a precinct as first report of the night,,1223,100,>98% reported,edison,>98%,48081,2020-11-04T10:44:16Z,R+79,Cornyn +79,78.9261,republican,Coke,5,,,5,1681,2,1732,3,4,1537,2621,170,298,22,32,0,1,1084,128,10,0
some,3691.0,Released as a precinct as first report of the night,,3507,94,94% reported,edison,94%,48083,2020-11-06T13:39:27Z,R+78,Cornyn +78,77.7313,republican,Coleman,5,,,4,4302,2,4064,16,30,3585,6681,426,795,37,65,0,14,3096,369,28,0
unknown,368567.0,Released as a precinct as first report of the night,,460756,98,98% reported,edison,98%,48085,2020-11-04T10:44:16Z,R+12,Cornyn +12,11.86464,republican,Collin,240,,,240,486391,6,476323,2678,4964,260790,508689,204276,407520,8421,15613,451,2286,247899,203244,7192,135
unknown,1021.0,Released as a precinct as first report of the night,,824,87,87% reported,edison,87%,48087,2020-11-04T10:44:16Z,R+74,Cornyn +74,74.41275,republican,Collingsworth,8,,,6,1365,2,1192,4,6,1032,1745,145,249,10,15,2,2,713,104,5,0
unknown,6404.0,Released as a precinct as first report of the night,,7966,98,98% reported,edison,98%,48089,2020-11-06T18:35:27Z,R+51,Cornyn +51,50.73186,republican,Colorado,5,,,4,10053,2,9838,43,74,7336,13187,2345,4351,114,192,0,31,5851,2006,78,0
unknown,64101.0,Released as a precinct as first report of the night,,79101,99,>98% reported,edison,>98%,48091,2020-11-04T10:44:17Z,R+47,Cornyn +47,46.8453,republican,Comal,30,,,30,87942,6,87330,412,734,63043,119964,22133,42607,1740,3122,6,322,56921,20474,1382,2
unknown,4034.0,Released as a precinct as first report of the night,,4618,97,97% reported,edison,97%,48093,2020-11-04T10:44:17Z,R+70,Cornyn +70,70.34816,republican,Comanche,15,,,13,6184,2,6003,30,45,5053,8941,830,1486,90,149,0,15,3888,656,59,0
unknown,569.0,Released as a precinct as first report of the night,,777,99,>98% reported,edison,>98%,48095,2020-11-04T10:44:17Z,R+67,Cornyn +67,67.0409,republican,Concho,9,,,8,1261,2,1247,5,7,1029,1663,193,321,20,33,0,2,634,128,13,0
some,10395.0,Released as a precinct as first report of the night,,13576,100,>98% reported,edison,>98%,48097,2020-11-04T10:44:17Z,R+66,Cornyn +66,66.27617,republican,Cooke,30,,,27,18842,2,18865,85,129,15498,26476,2995,5349,277,467,30,44,10978,2354,190,10
some,16701.0,Released as a precinct as first report of the night,,19090,100,>98% reported,edison,>98%,48099,2020-11-04T10:44:17Z,R+36,Cornyn +36,35.52325,republican,Coryell,16,,,16,21555,2,23182,149,260,15331,27776,7096,13190,605,1044,3,111,12445,6094,439,1
unknown,690.0,Released as a precinct as first report of the night,,488,68,68% reported,edison,68%,48101,2020-11-04T10:44:17Z,R+65,Cornyn +65,64.63415,republican,Cottle,5,,,4,963,2,656,5,7,534,931,110,194,7,12,0,2,397,84,5,0
unknown,1280.0,Released as a precinct as first report of the night,,1067,82,82% reported,edison,82%,48103,2020-11-04T10:44:17Z,R+67,Cornyn +67,66.53144,republican,Crane,4,,,3,1799,2,1479,13,21,1213,2099,229,386,24,40,0,8,886,157,16,0
unknown,1379.0,Released as a precinct as first report of the night,,1153,79,79% reported,edison,79%,48105,2020-11-04T10:44:18Z,R+56,Cornyn +56,55.69705,republican,Crockett,5,,,4,1894,2,1492,12,16,1145,2042,314,554,21,33,0,4,897,240,12,0
unknown,1368.0,Released as a precinct as first report of the night,,1186,89,89% reported,edison,89%,48107,2020-11-04T10:44:18Z,R+46,Cornyn +46,46.25199,republican,Crosby,5,,,4,2110,2,1881,14,20,1356,2218,486,791,25,38,0,6,862,305,13,0
unknown,681.0,Released as a precinct as first report of the night,,516,68,68% reported,edison,68%,48109,2020-11-04T10:44:18Z,D+2,Hegar +2,2.31362,democrat,Culberson,6,,,5,1143,2,778,6,9,367,606,385,649,19,28,3,3,239,264,9,1
unknown,954.0,Released as a precinct as first report of the night,,1020,87,87% reported,edison,87%,48111,2020-11-04T10:44:18Z,R+73,Cornyn +73,73.38355,republican,Dallam,10,,,8,1823,2,1593,5,8,1368,2246,199,326,21,33,0,3,878,127,12,0
all,739551.0,Released as a precinct as first report of the night,,797503,93,93% reported,edison,93%,48113,2020-11-07T20:15:23Z,D+25,Hegar +25,25.07323,democrat,Dallas,1170,,,1085,986665,4,915283,8271,14640,330585,615061,560076,1054625,15880,27989,942,6369,284476,494549,12109,0
unknown,3346.0,Released as a precinct as first report of the night,,2822,85,85% reported,edison,85%,48115,2020-11-04T10:43:28Z,R+57,Cornyn +57,57.37435,republican,Dawson,10,,,8,4301,2,3641,14,22,2827,5087,738,1256,60,96,4,8,2260,518,36,0
unknown,5965.0,Released as a precinct as first report of the night,,6079,98,98% reported,edison,98%,48123,2020-11-04T10:43:31Z,R+64,Cornyn +64,63.58565,republican,De Witt,10,,,9,8082,2,7887,20,37,6399,11287,1384,2488,84,154,0,17,4888,1104,70,0
unknown,739.0,Released as a precinct as first report of the night,,3583,81,81% reported,edison,81%,48117,2020-11-04T10:43:28Z,R+47,Cornyn +47,46.83293,republican,Deaf Smith,5,,,4,5602,2,4531,36,56,3272,5950,1150,1987,73,121,0,20,2678,837,48,0
unknown,1505.0,Released as a precinct as first report of the night,,1790,94,94% reported,edison,94%,48119,2020-11-04T10:43:29Z,R+69,Cornyn +69,68.65613,republican,Delta,8,,,7,2693,2,2530,22,38,2107,3559,370,673,31,50,0,16,1452,303,19,0
all,280830.0,Released as a precinct as first report of the night,,379110,99,>98% reported,edison,>98%,48121,2020-11-04T10:43:30Z,R+15,Cornyn +15,14.55783,republican,Denton,186,,,186,416610,6,411902,2620,4811,230355,441541,170391,329019,8514,15604,59,2191,211186,158628,7090,15
unknown,846.0,Released as a precinct as first report of the night,,657,72,72% reported,edison,72%,48125,2020-11-04T10:43:33Z,R+70,Cornyn +70,70.36649,republican,Dickens,7,,,6,1325,2,955,4,6,805,1364,133,225,13,17,0,2,559,92,4,0
unknown,2084.0,Released as a precinct as first report of the night,,2376,83,83% reported,edison,83%,48127,2020-11-04T10:43:34Z,D+24,Hegar +24,24.45213,democrat,Dimmit,8,,,7,4193,2,3468,30,44,1274,2099,2122,3633,39,64,7,14,825,1511,25,1
unknown,1330.0,Released as a precinct as first report of the night,,1144,90,90% reported,edison,90%,48129,2020-11-04T10:43:35Z,R+76,Cornyn +76,76.12308,republican,Donley,7,,,6,1811,2,1625,4,5,1418,2424,181,305,22,35,0,1,1006,124,13,0
unknown,4122.0,Released as a precinct as first report of the night,,3462,78,78% reported,edison,78%,48131,2020-11-04T10:43:36Z,D+15,Hegar +15,15.19819,democrat,Duval,10,,,8,5647,2,4415,77,143,1785,3097,2456,4480,97,157,0,66,1312,2024,60,0
unknown,5907.0,Released as a precinct as first report of the night,,6369,98,98% reported,edison,98%,48133,2020-11-04T10:43:37Z,R+75,Cornyn +75,75.43077,republican,Eastland,10,,,9,8223,2,8067,31,49,6994,12517,909,1640,131,226,6,18,5523,731,95,2
unknown,35298.0,Released as a precinct as first report of the night,,34675,100,>98% reported,edison,>98%,48135,2020-11-04T10:43:37Z,R+48,Cornyn +48,48.31034,republican,Ector,41,,,37,43138,2,43411,275,446,31603,56948,10631,19199,902,1493,0,171,25345,8568,591,0
unknown,827.0,Released as a precinct as first report of the night,,733,78,78% reported,edison,78%,48137,2020-11-04T10:43:38Z,R+69,Cornyn +69,69.13706,republican,Edwards,5,,,4,1267,2,985,3,5,824,1434,143,255,14,23,2,2,610,112,9,0
some,157724.0,Released as a precinct as first report of the night,,205867,89,89% reported,edison,89%,48141,2020-11-04T10:43:42Z,D+32,Hegar +32,32.10801,democrat,El Paso,209,,,185,278210,2,247010,5881,10033,76859,139421,156169,289380,8006,13853,285,4152,62562,133211,5847,95
all,56843.0,Released as a precinct as first report of the night,,74778,99,>98% reported,edison,>98%,48139,2020-11-04T10:43:40Z,R+37,Cornyn +37,36.78874,republican,Ellis,50,,,50,85566,6,85007,583,1036,57007,107076,25734,48651,1587,2848,270,453,50069,22917,1261,78
unknown,13085.0,Released as a precinct as first report of the night,,13507,97,97% reported,edison,97%,48143,2020-11-04T10:43:42Z,R+65,Cornyn +65,64.95506,republican,Erath,22,,,20,17152,2,16690,102,172,13547,24522,2706,4931,335,572,0,70,10975,2225,237,0
unknown,3515.0,Released as a precinct as first report of the night,,3651,94,94% reported,edison,94%,48145,2020-11-04T20:56:56Z,R+39,Cornyn +39,39.24491,republican,Falls,13,,,11,6415,2,6039,19,25,4157,6518,1787,3028,76,119,0,6,2361,1241,43,0
unknown,8408.0,Released as a precinct as first report of the night,,10871,100,>98% reported,edison,>98%,48147,2020-11-04T10:43:44Z,R+63,Cornyn +63,63.04126,republican,Fannin,17,,,16,14223,2,14711,80,129,11816,20451,2542,4568,272,432,3,49,8635,2026,160,1
unknown,7646.0,Released as a precinct as first report of the night,,9244,97,97% reported,edison,97%,48149,2020-11-04T10:43:45Z,R+58,Cornyn +58,57.80131,republican,Fayette,27,,,24,13195,2,12844,45,74,10047,17195,2623,4613,129,206,0,29,7148,1990,77,0
unknown,1044.0,Released as a precinct as first report of the night,,1289,88,88% reported,edison,88%,48151,2020-11-04T10:43:46Z,R+59,Cornyn +59,59.14634,republican,Fisher,5,,,4,2042,2,1804,7,9,1418,2433,351,607,28,44,0,2,1015,256,16,0
unknown,2191.0,Released as a precinct as first report of the night,,1631,81,81% reported,edison,81%,48153,2020-11-04T10:43:47Z,R+58,Cornyn +58,58.2578,republican,Floyd,7,,,5,2463,2,1986,10,15,1552,2854,395,703,29,45,0,5,1302,308,16,0
unknown,398.0,Released as a precinct as first report of the night,,389,78,78% reported,edison,78%,48155,2020-11-04T10:43:49Z,R+57,Cornyn +57,57.22543,republican,Foard,5,,,4,667,2,519,1,2,404,708,107,186,7,12,0,1,304,79,5,0
unknown,267057.0,Released as a precinct as first report of the night,,318995,100,>98% reported,edison,>98%,48157,2020-11-04T23:45:51Z,D+5,Hegar +5,5.13371,democrat,Fort Bend,160,,,160,340686,2,347176,2109,3883,160841,308302,178664,343934,5350,9840,424,1774,147461,165270,4490,0
unknown,3878.0,Released as a precinct as first report of the night,,3890,91,91% reported,edison,91%,48159,2020-11-04T10:43:51Z,R+68,Cornyn +68,67.9773,republican,Franklin,9,,,8,5407,2,4934,12,19,4106,7317,752,1380,63,107,2,7,3211,628,44,0
unknown,7301.0,Released as a precinct as first report of the night,,6432,94,94% reported,edison,94%,48161,2020-11-04T10:43:52Z,R+62,Cornyn +62,61.70712,republican,Freestone,16,,,14,9074,2,8529,50,82,6812,11908,1549,2782,114,184,9,32,5096,1233,70,1
some,2129.0,Released as a precinct as first report of the night,,3478,86,86% reported,edison,86%,48163,2020-11-04T10:43:52Z,R+4,Cornyn +4,4.07581,republican,Frio,10,,,9,5720,2,4907,78,122,2479,4146,2279,4001,71,116,0,44,1667,1722,45,0
unknown,3944.0,Released as a precinct as first report of the night,,5017,100,>98% reported,edison,>98%,48165,2020-11-04T10:43:53Z,R+79,Cornyn +79,79.32239,republican,Gaines,9,,,9,5456,2,5726,18,32,5087,9589,545,991,76,131,0,14,4502,446,55,0
unknown,137290.0,Released as a precinct as first report of the night,,138502,100,>98% reported,edison,>98%,48167,2020-11-04T10:43:54Z,R+26,Cornyn +26,25.72822,republican,Galveston,93,,,89,151732,2,152187,962,1741,93700,179053,54545,104492,2980,5403,0,779,85353,49947,2423,0
unknown,1568.0,Released as a precinct as first report of the night,,1215,88,88% reported,edison,88%,48169,2020-11-04T10:43:56Z,R+71,Cornyn +71,71.02167,republican,Garza,7,,,6,1842,2,1615,7,11,1372,2415,225,389,11,15,0,4,1043,164,4,0
unknown,13119.0,Released as a precinct as first report of the night,,12619,94,94% reported,edison,94%,48171,2020-11-04T10:43:57Z,R+61,Cornyn +61,60.56392,republican,Gillespie,14,,,13,16761,2,15747,39,64,12522,22332,2985,5630,200,338,3,25,9810,2645,138,1
unknown,495.0,Released as a precinct as first report of the night,,485,82,82% reported,edison,82%,48173,2020-11-04T10:43:59Z,R+88,Cornyn +88,87.9257,republican,Glasscock,5,,,4,785,2,646,3,4,603,1056,35,62,5,9,0,1,453,27,4,0
unknown,3358.0,Released as a precinct as first report of the night,,2848,89,89% reported,edison,89%,48175,2020-11-04T10:43:59Z,R+55,Cornyn +55,55.39882,republican,Goliad,10,,,8,4378,2,3899,14,19,2995,5159,835,1481,43,68,32,5,2164,646,25,8
unknown,5788.0,Released as a precinct as first report of the night,,5938,99,>98% reported,edison,>98%,48177,2020-11-04T10:44:00Z,R+52,Cornyn +52,51.50249,republican,Gonzales,16,,,14,7480,2,7421,41,68,5556,10010,1734,3135,89,144,3,27,4454,1401,55,1
unknown,7277.0,Released as a precinct as first report of the night,,5688,87,87% reported,edison,87%,48179,2020-11-04T10:44:01Z,R+77,Cornyn +77,77.28402,republican,Gray,8,,,6,8745,2,7651,42,74,6678,11652,765,1344,166,269,0,32,4974,579,103,0
unknown,43337.0,Released as a precinct as first report of the night,,49919,100,>98% reported,edison,>98%,48181,2020-11-04T10:44:02Z,R+51,Cornyn +51,50.91077,republican,Grayson,37,,,35,55994,2,58302,288,496,43350,80453,13668,25527,996,1745,0,208,37103,11859,749,0
all,51605.0,Released as a precinct as first report of the night,,42272,96,96% reported,edison,96%,48183,2020-11-04T10:44:02Z,R+39,Cornyn +39,39.05518,republican,Gregg,22,,,19,49302,4,47205,204,370,32326,61404,13890,26302,784,1399,3,166,29078,12412,615,1
unknown,7009.0,Released as a precinct as first report of the night,,9412,100,>98% reported,edison,>98%,48185,2020-11-04T10:44:04Z,R+54,Cornyn +54,54.24586,republican,Grimes,15,,,15,11258,2,12259,60,101,9325,16426,2675,4820,199,324,0,41,7101,2145,125,0
some,55597.0,Released as a precinct as first report of the night,,67556,100,>98% reported,edison,>98%,48187,2020-11-04T10:44:06Z,R+28,Cornyn +28,28.09141,republican,Guadalupe,72,,,72,71385,2,76753,428,762,48176,90243,26615,50578,1531,2721,8,334,42067,23963,1190,2
unknown,8534.0,Released as a precinct as first report of the night,,7351,89,89% reported,edison,89%,48189,2020-11-04T10:44:07Z,R+52,Cornyn +52,51.68948,republican,Hale,31,,,25,10460,2,9352,66,102,6983,12602,2149,3741,154,258,0,36,5619,1592,104,0
unknown,871.0,Released as a precinct as first report of the night,,793,87,87% reported,edison,87%,48191,2020-11-04T10:44:08Z,R+71,Cornyn +71,71.0642,republican,Hall,5,,,4,1308,2,1137,10,15,964,1634,156,269,7,12,0,5,670,113,5,0
unknown,3191.0,Released as a precinct as first report of the night,,3246,100,>98% reported,edison,>98%,48193,2020-11-04T10:44:09Z,R+70,Cornyn +70,69.70051,republican,Hamilton,12,,,11,4275,2,4274,45,87,3572,6256,593,1067,63,108,3,42,2684,474,45,1
unknown,1429.0,Released as a precinct as first report of the night,,1348,87,87% reported,edison,87%,48195,2020-11-04T10:44:09Z,R+83,Cornyn +83,83.08605,republican,Hansford,8,,,6,2317,2,2022,5,10,1838,3067,158,262,21,31,0,5,1229,104,10,0
unknown,1239.0,Released as a precinct as first report of the night,,1001,87,87% reported,edison,87%,48197,2020-11-04T10:44:09Z,R+70,Cornyn +70,69.51768,republican,Hardeman,4,,,3,1787,2,1555,1,2,1313,2147,232,393,9,14,0,1,834,161,5,0
unknown,18988.0,Released as a precinct as first report of the night,,22582,100,>98% reported,edison,>98%,48199,2020-11-04T10:44:09Z,R+74,Cornyn +74,73.62947,republican,Hardin,20,,,18,26901,2,27307,87,148,23468,42815,3362,6262,390,664,0,61,19347,2900,274,0
some,1267589.0,Released as a precinct as first report of the night,,1413822,94,94% reported,edison,94%,48201,2020-11-06T14:00:30Z,D+8,Hegar +8,8.14358,democrat,Harris,1013,,,955,1705746,2,1608003,12801,22611,717549,1344484,848498,1602878,29134,51810,63,9810,626935,754380,22676,21
some,29321.0,Released as a precinct as first report of the night,,25284,93,93% reported,edison,93%,48203,2020-11-04T10:44:10Z,R+47,Cornyn +47,46.58042,republican,Harrison,27,,,23,31350,2,29141,99,182,21091,39367,7517,14113,434,763,0,83,18276,6596,329,0
unknown,1711.0,Released as a precinct as first report of the night,,1614,90,90% reported,edison,90%,48205,2020-11-04T10:44:10Z,R+81,Cornyn +81,81.20773,republican,Hartley,7,,,6,2305,2,2070,10,14,1857,3312,176,311,27,47,0,4,1455,135,20,0
unknown,1208.0,Released as a precinct as first report of the night,,1364,92,92% reported,edison,92%,48207,2020-11-04T10:44:11Z,R+67,Cornyn +67,66.88073,republican,Haskell,5,,,5,2374,2,2180,13,20,1805,2922,347,579,15,23,0,7,1117,232,8,0
some,65929.0,Released as a precinct as first report of the night,,97630,100,>98% reported,edison,>98%,48209,2020-11-04T10:44:11Z,D+6,Hegar +6,5.59316,democrat,Hays,69,,,69,91536,2,107989,811,1464,49279,93360,55319,106125,2579,4668,3,653,44081,50806,2089,1
unknown,1081.0,Released as a precinct as first report of the night,,1154,85,85% reported,edison,85%,48211,2020-11-04T10:44:12Z,R+75,Cornyn +75,74.89663,republican,Hemphill,9,,,7,2002,2,1693,9,13,1465,2464,197,336,22,34,0,4,999,139,12,0
unknown,26045.0,Released as a precinct as first report of the night,,29551,100,>98% reported,edison,>98%,48213,2020-11-04T10:44:12Z,R+61,Cornyn +61,61.03763,republican,Henderson,28,,,26,35481,2,35986,179,296,28625,52111,6660,12240,522,890,0,117,23486,5580,368,0
some,168180.0,Released as a precinct as first report of the night,,178272,92,92% reported,edison,92%,48215,2020-11-06T21:29:25Z,D+16,Hegar +16,15.60392,democrat,Hidalgo,256,,,237,225468,2,208422,3102,5451,83808,154993,116330,217216,5023,8867,326,2349,71185,100886,3844,8
all,8740.0,Released as a precinct as first report of the night,,9572,99,>98% reported,edison,>98%,48217,2020-11-04T10:44:13Z,R+62,Cornyn +62,61.92673,republican,Hill,22,,,19,14843,6,14740,97,150,11788,19321,2660,4541,195,300,0,53,7533,1881,105,0
unknown,6866.0,Released as a precinct as first report of the night,,6242,92,92% reported,edison,92%,48219,2020-11-04T10:44:14Z,R+63,Cornyn +63,63.42227,republican,Hockley,15,,,13,8633,2,7983,28,42,6447,11514,1384,2468,122,197,6,14,5067,1084,75,2
some,23816.0,Released as a precinct as first report of the night,,25349,99,>98% reported,edison,>98%,48221,2020-11-06T21:12:18Z,R+65,Cornyn +65,65.32318,republican,Hood,16,,,15,32582,6,32180,189,318,26244,46780,5223,9594,508,819,34,129,20536,4371,311,2
unknown,12167.0,Released as a precinct as first report of the night,,12743,98,98% reported,edison,98%,48223,2020-11-04T10:44:15Z,R+62,Cornyn +62,61.76621,republican,Hopkins,22,,,20,15987,2,15638,81,138,12490,22661,2831,5180,236,402,0,57,10171,2349,166,0
unknown,7268.0,Released as a precinct as first report of the night,,6986,94,94% reported,edison,94%,48225,2020-11-04T13:49:55Z,R+52,Cornyn +52,51.53242,republican,Houston,22,,,18,9864,2,9299,28,41,6985,12144,2193,3944,91,153,5,13,5159,1751,62,1
unknown,8479.0,Released as a precinct as first report of the night,,8172,95,95% reported,edison,95%,48227,2020-11-04T10:44:15Z,R+59,Cornyn +59,58.62314,republican,Howard,27,,,23,10301,2,9834,44,70,7680,14078,1915,3519,190,329,15,26,6398,1604,139,5
unknown,355.0,Released as a precinct as first report of the night,,565,100,>98% reported,edison,>98%,48229,2020-11-04T10:44:15Z,R+20,Cornyn +20,19.94796,republican,Hudspeth,5,,,5,1132,2,1153,15,19,673,1035,443,633,21,30,2,4,362,190,9,0
unknown,22277.0,Released as a precinct as first report of the night,,27946,100,>98% reported,edison,>98%,48231,2020-11-04T10:59:55Z,R+54,Cornyn +54,54.12566,republican,Hunt,34,,,31,37262,2,38006,223,366,28864,49888,8293,14685,626,1013,0,143,21024,6392,387,0
unknown,7976.0,Released as a precinct as first report of the night,,6939,90,90% reported,edison,90%,48233,2020-11-04T10:44:16Z,R+77,Cornyn +77,76.92219,republican,Hutchinson,9,,,7,9631,2,8662,36,60,7555,13653,892,1590,175,292,10,24,6098,698,117,2
unknown,640.0,Released as a precinct as first report of the night,,662,86,86% reported,edison,86%,48235,2020-11-04T10:44:16Z,R+74,Cornyn +74,73.75,republican,Irion,5,,,4,1024,2,880,0,0,760,1328,111,200,9,14,0,0,568,89,5,0
unknown,2721.0,Released as a precinct as first report of the night,,2878,93,93% reported,edison,93%,48237,2020-11-04T10:44:16Z,R+81,Cornyn +81,81.14688,republican,Jack,7,,,6,3956,2,3697,17,30,3319,5899,319,574,41,70,3,13,2580,255,29,1
unknown,4125.0,Released as a precinct as first report of the night,,5062,98,98% reported,edison,98%,48239,2020-11-04T10:44:16Z,R+66,Cornyn +66,65.7532,republican,Jackson,10,,,9,6262,2,6167,26,46,5058,9239,1003,1810,76,127,11,20,4181,807,51,3
unknown,13365.0,Released as a precinct as first report of the night,,12546,96,96% reported,edison,96%,48241,2020-11-04T10:44:16Z,R+62,Cornyn +62,61.8208,republican,Jasper,21,,,18,15961,2,15257,41,74,12235,22235,2803,5193,175,295,9,33,10000,2390,120,3
unknown,1320.0,Released as a precinct as first report of the night,,1025,85,85% reported,edison,85%,48243,2020-11-04T10:44:17Z,R+22,Cornyn +22,22.02335,republican,Jeff Davis,6,,,5,1510,2,1285,6,12,766,1367,483,883,30,48,0,6,601,400,18,0
all,111555.0,Released as a precinct as first report of the night,,82650,89,89% reported,edison,89%,48245,2020-11-04T10:44:17Z,R+3,Cornyn +3,3.04842,republican,Jefferson,140,,,114,104649,2,92835,462,837,46893,88638,44063,83501,1413,2503,10,375,41745,39438,1090,2
unknown,974.0,Released as a precinct as first report of the night,,2622,100,>98% reported,edison,>98%,48247,2020-11-04T10:44:17Z,D+26,Hegar +26,26.38436,democrat,Jim Hogg,6,,,6,2755,2,3684,52,84,1300,2096,2272,4036,60,90,0,32,796,1764,30,0
unknown,4321.0,Released as a precinct as first report of the night,,9682,81,81% reported,edison,81%,48249,2020-11-05T14:29:54Z,R+7,Cornyn +7,7.42691,republican,Jim Wells,22,,,17,16093,2,13101,107,172,6900,11880,5927,10458,167,273,0,65,4980,4531,106,0
all,51853.0,Released as a precinct as first report of the night,,60709,99,>98% reported,edison,>98%,48251,2020-11-04T10:44:17Z,R+54,Cornyn +54,54.49792,republican,Johnson,36,,,34,71928,6,71333,369,630,54306,100371,15431,28886,1212,2128,42,261,46065,13455,916,12
unknown,3234.0,Released as a precinct as first report of the night,,4323,93,93% reported,edison,93%,48253,2020-11-04T10:44:17Z,R+69,Cornyn +69,69.21321,republican,Jones,12,,,10,7038,2,6571,27,44,5506,9099,958,1623,80,128,0,17,3593,665,48,0
unknown,2303.0,Released as a precinct as first report of the night,,3575,100,>98% reported,edison,>98%,48255,2020-11-04T10:44:17Z,R+52,Cornyn +52,52.40726,republican,Karnes,15,,,14,4957,2,5068,20,35,3823,6459,1167,2057,58,92,0,15,2636,890,34,0
all,36321.0,Released as a precinct as first report of the night,,48257,100,>98% reported,edison,>98%,48257,2020-11-04T10:44:17Z,R+36,Cornyn +36,35.74439,republican,Kaufman,31,,,31,48730,4,56241,349,615,37504,69422,17401,32702,953,1699,94,266,31918,15301,746,26
unknown,20363.0,Released as a precinct as first report of the night,,23479,100,>98% reported,edison,>98%,48259,2020-11-04T10:44:18Z,R+58,Cornyn +58,57.80408,republican,Kendall,11,,,11,25521,2,26358,99,170,20561,38755,5325,10245,373,667,0,71,18194,4920,294,0
unknown,104.0,Released as a precinct as first report of the night,,111,70,70% reported,edison,70%,48261,2020-11-04T10:44:18Z,R+30,Cornyn +30,29.5858,republican,Kenedy,6,,,4,242,2,169,1,2,107,177,57,94,4,7,0,1,70,37,3,0
unknown,353.0,Released as a precinct as first report of the night,,309,79,79% reported,edison,79%,48263,2020-11-04T10:44:18Z,R+75,Cornyn +75,74.83146,republican,Kent,7,,,6,564,2,445,2,2,386,646,53,100,4,6,0,0,260,47,2,0
some,26771.0,Released as a precinct as first report of the night,,23890,96,96% reported,edison,96%,48265,2020-11-04T10:43:27Z,R+55,Cornyn +55,54.77913,republican,Kerr,21,,,19,28762,4,27505,127,219,21000,39138,5933,11265,444,771,3,92,18138,5332,327,1
unknown,1950.0,Released as a precinct as first report of the night,,1778,98,98% reported,edison,98%,48267,2020-11-04T10:43:28Z,R+76,Cornyn +76,75.81003,republican,Kimble,8,,,7,2305,2,2253,9,14,1962,3515,254,455,28,47,0,5,1553,201,19,0
unknown,125.0,Released as a precinct as first report of the night,,0,74,74% reported,edison,74%,48269,2020-11-04T10:43:28Z,R+94,Cornyn +94,93.50649,republican,King,5,,,4,207,2,154,0,0,149,149,5,5,0,0,0,0,0,0,0,0
unknown,1498.0,Released as a precinct as first report of the night,,1269,81,81% reported,edison,81%,48271,2020-11-04T10:43:29Z,R+45,Cornyn +45,44.76127,republican,Kinney,4,,,3,1859,2,1508,13,22,1070,1972,395,729,25,44,15,9,902,334,19,5
unknown,8039.0,Released as a precinct as first report of the night,,8730,87,87% reported,edison,87%,48273,2020-11-04T10:43:29Z,R+3,Cornyn +3,2.87936,republican,Kleberg,18,,,16,12366,2,10801,84,147,5421,9682,5110,9390,184,308,6,63,4261,4280,124,2
unknown,343.0,Released as a precinct as first report of the night,,763,80,80% reported,edison,80%,48275,2020-11-04T10:43:30Z,R+62,Cornyn +62,61.81818,republican,Knox,7,,,6,1783,2,1430,5,5,1147,1759,263,412,15,17,0,0,612,149,2,0
unknown,1195.0,Released as a precinct as first report of the night,,2938,100,>98% reported,edison,>98%,48283,2020-11-04T10:43:36Z,R+4,Cornyn +4,3.58807,republican,La Salle,5,,,5,2677,2,4292,58,92,2164,3654,2010,3390,60,94,0,34,1490,1380,34,0
unknown,5887.0,Released as a precinct as first report of the night,,7235,98,98% reported,edison,98%,48285,2020-11-04T10:43:37Z,R+73,Cornyn +73,72.65843,republican,La Vaca,20,,,18,10228,2,10036,23,39,8597,14754,1305,2299,109,175,6,16,6157,994,66,2
unknown,15300.0,Released as a precinct as first report of the night,,16488,99,>98% reported,edison,>98%,48277,2020-11-04T10:43:32Z,R+58,Cornyn +58,57.67916,republican,Lamar,27,,,24,21338,6,21070,99,168,16417,29065,4264,7825,276,475,39,69,12648,3561,199,11
unknown,2723.0,Released as a precinct as first report of the night,,3063,90,90% reported,edison,90%,48279,2020-11-04T10:43:34Z,R+61,Cornyn +61,61.29995,republican,Lamb,12,,,10,4831,2,4354,22,34,3463,5906,794,1354,74,121,3,12,2443,560,47,1
unknown,6404.0,Released as a precinct as first report of the night,,8584,100,>98% reported,edison,>98%,48281,2020-11-04T10:43:35Z,R+59,Cornyn +59,59.3653,republican,Lampasas,10,,,10,9690,2,10304,61,106,8086,14761,1969,3694,188,327,0,45,6675,1725,139,0
unknown,5270.0,Released as a precinct as first report of the night,,6507,100,>98% reported,edison,>98%,48287,2020-11-04T10:43:38Z,R+56,Cornyn +56,56.33416,republican,Lee,16,,,15,7718,2,8020,36,62,6203,11203,1685,3097,96,165,0,26,5000,1412,69,0
some,4924.0,Released as a precinct as first report of the night,,5656,98,98% reported,edison,98%,48289,2020-11-04T10:43:39Z,R+74,Cornyn +74,73.66905,republican,Leon,18,,,16,8785,2,8678,41,63,7420,12280,1027,1744,102,159,176,22,4860,717,57,0
unknown,23806.0,Released as a precinct as first report of the night,,24129,100,>98% reported,edison,>98%,48291,2020-11-04T10:43:41Z,R+59,Cornyn +59,58.90307,republican,Liberty,30,,,28,28657,2,28990,127,220,22731,41896,5655,10175,477,828,0,93,19165,4520,351,0
unknown,6531.0,Released as a precinct as first report of the night,,6792,98,98% reported,edison,98%,48293,2020-11-04T10:43:42Z,R+51,Cornyn +51,50.65819,republican,Limestone,21,,,19,9139,2,8964,77,124,6653,11613,2112,3801,122,218,0,47,4960,1689,96,0
unknown,482.0,Released as a precinct as first report of the night,,562,84,84% reported,edison,84%,48295,2020-11-04T10:43:43Z,R+80,Cornyn +80,80.34769,republican,Lipscomb,7,,,5,1573,2,1323,1,1,1180,1669,117,186,25,29,0,0,489,69,4,0
unknown,3171.0,Released as a precinct as first report of the night,,3388,98,98% reported,edison,98%,48297,2020-11-04T10:43:44Z,R+67,Cornyn +67,66.88755,republican,Live Oak,15,,,13,5081,2,4980,14,20,4121,6904,790,1353,55,91,0,6,2783,563,36,0
unknown,11573.0,Released as a precinct as first report of the night,,11135,97,97% reported,edison,97%,48299,2020-11-04T10:43:45Z,R+62,Cornyn +62,61.50333,republican,Llano,10,,,9,12897,2,12479,46,85,9969,18824,2294,4414,170,291,0,39,8855,2120,121,0
unknown,56.0,Released as a precinct as first report of the night,,45,78,78% reported,edison,78%,48301,2020-11-04T10:43:45Z,R+80,Cornyn +80,80.30303,republican,Loving,5,,,4,85,2,66,0,0,58,99,5,8,3,4,0,0,41,3,1,0
some,108791.0,Released as a precinct as first report of the night,,105236,99,>98% reported,edison,>98%,48303,2020-11-04T10:43:46Z,R+36,Cornyn +36,36.20987,republican,Lubbock,98,,,91,120204,6,118951,695,1221,79160,149655,36088,67949,3002,5350,18,526,70495,31861,2348,6
unknown,1615.0,Released as a precinct as first report of the night,,2263,95,95% reported,edison,95%,48305,2020-11-04T10:43:47Z,R+62,Cornyn +62,62.12992,republican,Lynn,15,,,13,2373,2,2263,10,20,1817,3634,411,822,25,50,0,10,1817,411,25,0
unknown,4216.0,Released as a precinct as first report of the night,,4325,100,>98% reported,edison,>98%,48313,2020-11-04T10:43:52Z,R+59,Cornyn +59,59.14494,republican,Madison,5,,,5,5065,2,5216,14,26,4113,7512,1028,1902,61,101,0,12,3399,874,40,0
unknown,3462.0,Released as a precinct as first report of the night,,3637,94,94% reported,edison,94%,48315,2020-11-04T10:43:53Z,R+44,Cornyn +44,44.36471,republican,Marion,10,,,9,5057,2,4738,17,30,3369,5935,1267,2268,85,142,0,13,2566,1001,57,0
unknown,738.0,Released as a precinct as first report of the night,,1667,100,>98% reported,edison,>98%,48317,2020-11-04T10:43:53Z,R+73,Cornyn +73,73.29545,republican,Martin,6,,,6,2081,2,2112,11,19,1811,3254,263,459,27,47,0,8,1443,196,20,0
unknown,2092.0,Released as a precinct as first report of the night,,2293,100,>98% reported,edison,>98%,48319,2020-11-04T10:43:54Z,R+56,Cornyn +56,56.28672,republican,Mason,5,,,5,2429,2,2553,7,13,1979,3754,542,1034,25,45,0,6,1775,492,20,0
unknown,12052.0,Released as a precinct as first report of the night,,10783,94,94% reported,edison,94%,48321,2020-11-04T10:43:56Z,R+45,Cornyn +45,45.2183,republican,Matagorda,19,,,16,14402,2,13468,62,108,9637,17317,3547,6448,222,378,0,46,7680,2901,156,0
unknown,9456.0,Released as a precinct as first report of the night,,21382,100,>98% reported,edison,>98%,48323,2020-11-06T22:07:49Z,D+16,Hegar +16,15.74417,democrat,Maverick,14,,,14,17664,2,28582,698,1124,11416,19644,15916,28294,538,878,38,426,8228,12378,340,10
unknown,3128.0,Released as a precinct as first report of the night,,2632,92,92% reported,edison,92%,48307,2020-11-04T10:43:49Z,R+70,Cornyn +70,70.34626,republican,McCulloch,4,,,3,3664,2,3379,19,30,2837,5032,460,842,63,107,0,11,2195,382,44,0
some,70693.0,Released as a precinct as first report of the night,,78875,98,98% reported,edison,98%,48309,2020-11-04T10:43:50Z,R+28,Cornyn +28,27.73815,republican,McLennan,92,,,86,97624,2,95886,638,1078,59916,108370,33319,61893,2010,3414,9,440,48454,28574,1404,3
unknown,417.0,Released as a precinct as first report of the night,,359,76,76% reported,edison,76%,48311,2020-11-04T10:43:51Z,R+82,Cornyn +82,82.2,republican,McMullen,5,,,4,654,2,500,1,1,454,791,43,64,2,3,0,0,337,21,1,0
unknown,18044.0,Released as a precinct as first report of the night,,19556,100,>98% reported,edison,>98%,48325,2020-11-04T10:43:59Z,R+42,Cornyn +42,42.37617,republican,Medina,8,,,8,20366,2,22128,96,175,15548,29332,6171,11612,311,561,6,79,13784,5441,250,2
unknown,813.0,Released as a precinct as first report of the night,,779,89,89% reported,edison,89%,48327,2020-11-04T10:43:59Z,R+61,Cornyn +61,60.80402,republican,Menard,7,,,6,1123,2,995,4,7,793,1413,188,342,10,12,0,3,620,154,2,0
some,52107.0,Released as a precinct as first report of the night,,49608,96,96% reported,edison,96%,48329,2020-11-04T10:44:00Z,R+59,Cornyn +59,58.69766,republican,Midland,45,,,41,60756,2,58326,215,354,45584,84434,11348,21062,1160,2050,53,139,38850,9714,890,15
unknown,7689.0,Released as a precinct as first report of the night,,8710,100,>98% reported,edison,>98%,48331,2020-11-04T10:44:01Z,R+52,Cornyn +52,52.15022,republican,Milam,12,,,11,10231,2,10278,53,94,7725,14285,2365,4377,135,232,0,41,6560,2012,97,0
unknown,2437.0,Released as a precinct as first report of the night,,1934,94,94% reported,edison,94%,48333,2020-11-04T10:44:01Z,R+78,Cornyn +78,78.1401,republican,Mills,8,,,7,2652,2,2484,9,15,2193,3884,252,461,30,58,0,6,1691,209,28,0
some,2166.0,Released as a precinct as first report of the night,,1868,93,93% reported,edison,93%,48335,2020-11-04T10:44:02Z,R+70,Cornyn +70,69.64567,republican,Mitchell,7,,,6,2735,2,2540,12,19,2128,3693,359,625,40,69,3,7,1565,266,29,1
some,582.0,Released as a precinct as first report of the night,,7997,96,96% reported,edison,96%,48337,2020-11-04T10:44:02Z,R+77,Cornyn +77,76.55194,republican,Montague,16,,,14,10160,2,9762,47,81,8524,15499,1051,1938,135,231,15,34,6975,887,96,5
some,200221.0,Released as a precinct as first report of the night,,234419,100,>98% reported,edison,>98%,48339,2020-11-04T10:44:05Z,R+47,Cornyn +47,47.00122,republican,Montgomery,101,,,101,259565,4,268559,1206,2105,194368,363772,68142,128546,4840,8549,9,899,169404,60404,3709,3
unknown,3973.0,Released as a precinct as first report of the night,,3730,87,87% reported,edison,87%,48341,2020-11-04T10:44:07Z,R+61,Cornyn +61,60.9263,republican,Moore,8,,,6,6240,2,5441,32,45,4311,7444,996,1527,102,155,0,13,3133,531,53,0
unknown,4099.0,Released as a precinct as first report of the night,,4072,90,90% reported,edison,90%,48343,2020-11-04T10:44:07Z,R+38,Cornyn +38,38.40367,republican,Morris,9,,,8,6066,2,5450,21,32,3727,6475,1634,2907,66,105,5,11,2748,1273,39,1
unknown,503.0,Released as a precinct as first report of the night,,432,80,80% reported,edison,80%,48345,2020-11-04T10:44:08Z,R+86,Cornyn +86,85.73668,republican,Motley,7,,,6,800,2,638,0,0,591,990,44,76,3,4,0,0,399,32,1,0
unknown,20976.0,Released as a precinct as first report of the night,,22191,95,95% reported,edison,95%,48347,2020-11-04T10:44:09Z,R+34,Cornyn +34,33.50081,republican,Nacogdoches,26,,,23,27929,2,26471,162,285,17349,31546,8481,15985,476,842,7,123,14197,7504,366,1
unknown,13004.0,Released as a precinct as first report of the night,,13936,98,98% reported,edison,98%,48349,2020-11-04T10:44:09Z,R+47,Cornyn +47,46.80526,republican,Navarro,30,,,27,19406,2,18953,133,201,13688,23696,4817,8460,315,532,0,68,10008,3643,217,0
unknown,3864.0,Released as a precinct as first report of the night,,4037,87,87% reported,edison,87%,48351,2020-11-04T10:44:09Z,R+60,Cornyn +60,60.12627,republican,Newton,23,,,19,6911,2,6019,23,35,4784,7953,1165,1990,46,77,2,12,3169,825,31,0
unknown,3284.0,Released as a precinct as first report of the night,,3510,92,92% reported,edison,92%,48353,2020-11-04T10:44:10Z,R+57,Cornyn +57,57.23223,republican,Nolan,10,,,8,5736,2,5275,18,25,4096,6780,1077,1847,84,133,0,7,2684,770,49,0
unknown,100673.0,Released as a precinct as first report of the night,,109447,92,92% reported,edison,92%,48355,2020-11-04T10:44:10Z,R+6,Cornyn +6,5.92457,republican,Nueces,128,,,118,135727,2,124988,991,1742,64418,120566,57013,107602,2556,4505,30,751,56148,50589,1949,10
unknown,2376.0,Released as a precinct as first report of the night,,2215,88,88% reported,edison,88%,48357,2020-11-04T10:44:10Z,R+81,Cornyn +81,80.64412,republican,Ochiltree,5,,,4,3545,2,3105,8,13,2782,4783,278,462,36,60,3,5,2001,184,24,1
unknown,538.0,Released as a precinct as first report of the night,,618,81,81% reported,edison,81%,48359,2020-11-04T10:44:11Z,R+84,Cornyn +84,83.73494,republican,Oldham,8,,,6,1232,2,996,5,6,908,1482,74,111,9,15,0,1,574,37,6,0
unknown,33059.0,Released as a precinct as first report of the night,,30286,94,94% reported,edison,94%,48361,2020-11-04T10:44:11Z,R+63,Cornyn +63,62.95341,republican,Orange,35,,,30,37789,2,35674,140,257,28704,53070,6246,11604,572,1005,36,117,24366,5358,433,12
unknown,7232.0,Released as a precinct as first report of the night,,9502,100,>98% reported,edison,>98%,48363,2020-11-04T10:44:12Z,R+65,Cornyn +65,64.6586,republican,Palo Pinto,28,,,26,12128,2,12317,70,122,9990,17601,2026,3709,231,387,0,52,7611,1683,156,0
unknown,9139.0,Released as a precinct as first report of the night,,7983,92,92% reported,edison,92%,48365,2020-11-04T10:44:12Z,R+63,Cornyn +63,63.08428,republican,Panola,20,,,17,12300,2,11296,30,44,9141,15563,2015,3491,109,179,3,14,6422,1476,70,1
all,50658.0,Released as a precinct as first report of the night,,64871,96,96% reported,edison,96%,48367,2020-11-04T10:44:13Z,R+66,Cornyn +66,66.15716,republican,Parker,44,,,44,78000,2,74843,322,573,61235,114288,11721,22108,1562,2740,8,251,53053,10387,1178,2
unknown,1526.0,Released as a precinct as first report of the night,,1300,79,79% reported,edison,79%,48369,2020-11-04T10:44:13Z,R+64,Cornyn +64,63.82331,republican,Parmer,10,,,8,3309,2,2626,13,13,2130,3226,454,652,28,34,2,0,1096,198,6,0
some,4379.0,Released as a precinct as first report of the night,,3800,84,84% reported,edison,84%,48371,2020-11-04T10:44:14Z,R+37,Cornyn +37,37.37949,republican,Pecos,10,,,8,5441,2,4564,32,56,3079,5654,1373,2523,79,129,3,24,2575,1150,50,1
unknown,22445.0,Released as a precinct as first report of the night,,19833,100,>98% reported,edison,>98%,48373,2020-11-04T10:44:14Z,R+53,Cornyn +53,53.21211,republican,Polk,22,,,20,23444,2,23427,133,223,17668,32611,5202,9670,424,756,0,90,14943,4468,332,0
some,24501.0,Released as a precinct as first report of the night,,26506,99,>98% reported,edison,>98%,48375,2020-11-04T10:44:14Z,R+41,Cornyn +41,41.19806,republican,Potter,25,,,22,33177,6,32703,245,403,22593,41049,9120,16492,737,1255,18,158,18456,7372,518,2
unknown,1723.0,Released as a precinct as first report of the night,,1708,73,73% reported,edison,73%,48377,2020-11-04T10:44:15Z,D+35,Hegar +35,34.57676,democrat,Presidio,8,,,6,2870,2,2091,37,61,651,1139,1374,2550,29,49,0,24,488,1176,20,0
unknown,3940.0,Released as a precinct as first report of the night,,4946,100,>98% reported,edison,>98%,48379,2020-11-04T10:44:15Z,R+72,Cornyn +72,71.70002,republican,Rains,9,,,9,5551,2,5947,26,45,5052,9264,788,1451,81,133,0,19,4212,663,52,0
all,56579.0,Released as a precinct as first report of the night,,55834,93,93% reported,edison,93%,48381,2020-11-04T10:44:15Z,R+61,Cornyn +61,61.42645,republican,Randall,23,,,21,68884,4,64075,233,409,50926,95462,11567,21672,1343,2356,16,176,44536,10105,1013,4
unknown,756.0,Released as a precinct as first report of the night,,857,91,91% reported,edison,91%,48383,2020-11-04T10:44:15Z,R+69,Cornyn +69,69.13003,republican,Reagan,5,,,5,1175,2,1069,9,16,893,1614,154,273,13,23,0,7,721,119,10,0
unknown,1530.0,Released as a precinct as first report of the night,,1614,98,98% reported,edison,98%,48385,2020-11-04T10:44:16Z,R+69,Cornyn +69,69.10779,republican,Real,6,,,5,1985,2,1939,8,12,1626,2978,286,529,19,34,0,4,1352,243,15,0
unknown,5311.0,Released as a precinct as first report of the night,,4217,94,94% reported,edison,94%,48387,2020-11-04T10:44:16Z,R+57,Cornyn +57,56.9083,republican,Red River,20,,,17,6094,2,5725,31,47,4447,7660,1189,2147,58,88,0,16,3213,958,30,0
unknown,2241.0,Released as a precinct as first report of the night,,2549,83,83% reported,edison,83%,48389,2020-11-04T11:39:56Z,R+19,Cornyn +19,18.68805,republican,Reeves,12,,,9,4139,2,3430,43,67,1978,3389,1337,2409,72,114,0,24,1411,1072,42,0
unknown,2120.0,Released as a precinct as first report of the night,,2393,91,91% reported,edison,91%,48391,2020-11-04T10:44:16Z,R+33,Cornyn +33,33.07062,republican,Refugio,11,,,9,3481,2,3172,24,38,2072,3652,1023,1788,52,86,2,14,1580,765,34,0
unknown,399.0,Released as a precinct as first report of the night,,360,76,76% reported,edison,76%,48393,2020-11-04T10:44:16Z,R+94,Cornyn +94,93.76147,republican,Roberts,5,,,4,720,2,545,0,0,526,874,15,24,4,7,0,0,348,9,3,0
unknown,7781.0,Released as a precinct as first report of the night,,6450,93,93% reported,edison,93%,48395,2020-11-04T10:44:16Z,R+42,Cornyn +42,41.97112,republican,Robertson,16,,,14,8605,2,7965,34,59,5575,10125,2232,4024,118,200,13,25,4550,1792,82,1
unknown,36546.0,Released as a precinct as first report of the night,,52391,100,>98% reported,edison,>98%,48397,2020-11-04T10:44:17Z,R+40,Cornyn +40,40.24678,republican,Rockwall,18,,,18,50672,2,57704,323,590,39824,75836,16600,31938,928,1673,87,267,36012,15338,745,29
unknown,,Released as a precinct as first report of the night,,3020,94,94% reported,edison,94%,48399,2020-11-04T10:44:17Z,R+74,Cornyn +74,74.25293,republican,Runnels,11,,,9,4467,2,4183,24,33,3603,6221,497,853,59,96,0,9,2618,356,37,0
some,18369.0,Released as a precinct as first report of the night,,16026,94,94% reported,edison,94%,48401,2020-11-04T10:44:17Z,R+56,Cornyn +56,56.22194,republican,Rusk,23,,,20,22430,4,21159,78,124,16346,28627,4450,7969,275,454,21,46,12281,3519,179,1
unknown,4544.0,Released as a precinct as first report of the night,,4269,98,98% reported,edison,98%,48403,2020-11-04T10:44:17Z,R+74,Cornyn +74,73.58107,republican,Sabine,9,,,8,5492,2,5409,22,38,4661,8327,681,1234,45,79,0,16,3666,553,34,0
unknown,3105.0,Released as a precinct as first report of the night,,2837,89,89% reported,edison,89%,48405,2020-11-04T10:44:17Z,R+51,Cornyn +51,50.86496,republican,San Augustine,12,,,10,4358,2,3873,12,21,2896,4944,926,1684,39,61,0,9,2048,758,22,0
unknown,9360.0,Released as a precinct as first report of the night,,10187,100,>98% reported,edison,>98%,48407,2020-11-04T10:44:17Z,R+61,Cornyn +61,61.02477,republican,San Jacinto,12,,,11,12214,2,12354,63,110,9803,17871,2264,4161,224,399,0,47,8068,1897,175,0
all,19161.0,Released as a precinct as first report of the night,,21558,100,>98% reported,edison,>98%,48409,2020-11-04T10:44:17Z,R+30,Cornyn +30,30.33623,republican,San Patricio,26,,,23,25280,6,25280,161,288,16151,29926,8482,15774,486,850,0,127,13775,7292,364,0
unknown,1940.0,Released as a precinct as first report of the night,,1785,90,90% reported,edison,90%,48411,2020-11-04T10:44:17Z,R+78,Cornyn +78,77.92,republican,San Saba,4,,,3,2783,2,2500,3,4,2218,3785,270,485,9,11,0,1,1567,215,2,0
unknown,1035.0,Released as a precinct as first report of the night,,890,90,90% reported,edison,90%,48413,2020-11-04T10:44:18Z,R+65,Cornyn +65,64.98674,republican,Schleicher,5,,,4,1251,2,1131,4,7,926,1659,191,337,10,18,0,3,733,146,8,0
unknown,4983.0,Released as a precinct as first report of the night,,4591,93,93% reported,edison,93%,48415,2020-11-04T10:43:28Z,R+70,Cornyn +70,70.09669,republican,Scurry,12,,,10,6246,2,5792,32,54,4865,8751,805,1435,89,142,2,22,3886,630,53,0
unknown,1206.0,Released as a precinct as first report of the night,,1231,87,87% reported,edison,87%,48417,2020-11-04T10:43:29Z,R+85,Cornyn +85,84.62974,republican,Shackelford,8,,,7,1857,2,1607,3,6,1475,2613,115,200,14,19,0,3,1138,85,5,0
unknown,7145.0,Released as a precinct as first report of the night,,6912,91,91% reported,edison,91%,48419,2020-11-04T10:43:29Z,R+59,Cornyn +59,58.59163,republican,Shelby,15,,,13,10952,2,9969,27,42,7854,13210,2013,3506,75,123,0,15,5356,1493,48,0
unknown,974.0,Released as a precinct as first report of the night,,678,73,73% reported,edison,73%,48421,2020-11-04T10:43:30Z,R+81,Cornyn +81,81.1359,republican,Sherman,5,,,4,1349,2,986,2,2,888,1492,88,157,7,11,3,0,604,69,4,1
all,90067.0,Released as a precinct as first report of the night,,86718,100,>98% reported,edison,>98%,48423,2020-11-04T10:43:32Z,R+41,Cornyn +41,41.30362,republican,Smith,74,,,67,99521,6,99093,437,767,69047,129662,28118,52755,1437,2532,149,330,60615,24637,1095,41
unknown,3539.0,Released as a precinct as first report of the night,,4248,100,>98% reported,edison,>98%,48425,2020-11-04T10:43:34Z,R+69,Cornyn +69,68.8708,republican,Somervell,4,,,4,4811,2,4915,27,48,4097,7640,712,1334,78,139,3,21,3543,622,61,1
unknown,12032.0,Released as a precinct as first report of the night,,12080,84,84% reported,edison,84%,48427,2020-11-04T10:43:35Z,D+16,Hegar +16,15.73507,democrat,Starr,10,,,10,17600,2,14706,385,690,5825,10476,8139,14975,356,643,3,305,4651,6836,287,1
unknown,3737.0,Released as a precinct as first report of the night,,2969,91,91% reported,edison,91%,48429,2020-11-04T10:43:36Z,R+79,Cornyn +79,78.70916,republican,Stephens,9,,,7,4087,2,3734,17,30,3312,5934,373,684,32,55,0,13,2622,311,23,0
unknown,408.0,Released as a precinct as first report of the night,,473,75,75% reported,edison,75%,48431,2020-11-04T10:43:36Z,R+84,Cornyn +84,83.73591,republican,Sterling,4,,,3,823,2,621,5,7,567,1004,47,80,2,3,0,2,437,33,1,0
unknown,437.0,Released as a precinct as first report of the night,,714,78,78% reported,edison,78%,48433,2020-11-04T10:43:37Z,R+65,Cornyn +65,64.98599,republican,Stonewall,4,,,3,911,2,714,3,6,586,1172,122,244,3,6,0,3,586,122,3,0
unknown,1807.0,Released as a precinct as first report of the night,,1309,79,79% reported,edison,79%,48435,2020-11-04T10:43:39Z,R+59,Cornyn +59,58.75817,republican,Sutton,5,,,4,1936,2,1530,10,18,1204,2237,305,567,10,15,3,8,1033,262,5,1
unknown,1756.0,Released as a precinct as first report of the night,,1742,87,87% reported,edison,87%,48437,2020-11-04T10:43:40Z,R+57,Cornyn +57,57.34024,republican,Swisher,9,,,7,2676,2,2316,15,23,1792,3165,464,799,44,70,2,8,1373,335,26,0
all,685898.0,Released as a precinct as first report of the night,,752265,95,95% reported,edison,95%,48439,2020-11-07T02:45:34Z,R+5,Cornyn +5,4.96642,republican,Tarrant,730,,,692,869068,4,823611,6088,11495,421016,808152,380112,725271,16377,30936,40,5407,387136,345159,14559,4
all,48518.0,Released as a precinct as first report of the night,,44935,99,>98% reported,edison,>98%,48441,2020-11-04T10:43:43Z,R+49,Cornyn +49,49.36438,republican,Taylor,35,,,32,54924,6,54278,309,537,39777,72486,12983,24103,1205,2079,12,228,32709,11120,874,4
unknown,648.0,Released as a precinct as first report of the night,,354,63,63% reported,edison,63%,48443,2020-11-04T10:43:44Z,R+46,Cornyn +46,46.22222,republican,Terrell,5,,,4,719,2,450,3,6,324,572,116,212,5,10,6,3,248,96,5,2
unknown,3782.0,Released as a precinct as first report of the night,,2825,80,80% reported,edison,80%,48445,2020-11-04T10:43:45Z,R+57,Cornyn +57,57.21591,republican,Terry,8,,,6,4378,2,3520,15,25,2728,4945,714,1265,63,110,0,10,2217,551,47,0
unknown,614.0,Released as a precinct as first report of the night,,528,83,83% reported,edison,83%,48447,2020-11-04T10:43:45Z,R+81,Cornyn +81,81.46453,republican,Throckmorton,6,,,5,1057,2,874,3,4,788,1267,76,120,7,11,0,1,479,44,4,0
unknown,7555.0,Released as a precinct as first report of the night,,8131,93,93% reported,edison,93%,48449,2020-11-04T10:43:46Z,R+45,Cornyn +45,45.10371,republican,Titus,19,,,16,11123,2,10365,50,85,7419,13308,2744,4848,152,255,0,35,5889,2104,103,0
unknown,37998.0,Released as a precinct as first report of the night,,33045,94,94% reported,edison,94%,48451,2020-11-06T22:58:52Z,R+47,Cornyn +47,46.92906,republican,Tom Green,35,,,35,47505,2,44514,231,372,32149,55645,11259,20131,873,1407,6,141,23496,8872,534,2
some,391428.0,Released as a precinct as first report of the night,,547352,98,98% reported,edison,98%,48453,2020-11-04T10:43:50Z,D+39,Hegar +39,38.71956,democrat,Travis,248,,,242,609336,4,595624,4145,7495,174380,328585,405003,785263,11910,21447,372,3350,154205,380260,9537,0
unknown,6125.0,Released as a precinct as first report of the night,,5244,92,92% reported,edison,92%,48455,2020-11-04T10:43:51Z,R+61,Cornyn +61,61.40841,republican,Trinity,20,,,17,7362,2,6802,30,52,5435,9641,1258,2228,79,125,0,22,4206,970,46,0
unknown,6461.0,Released as a precinct as first report of the night,,6601,99,>98% reported,edison,>98%,48457,2020-11-06T22:48:53Z,R+68,Cornyn +68,68.38134,republican,Tyler,18,,,11,9466,2,9409,53,90,7819,13209,1385,2462,152,249,0,37,5390,1077,97,0
unknown,12933.0,Released as a precinct as first report of the night,,15152,98,98% reported,edison,98%,48459,2020-11-04T10:43:52Z,R+68,Cornyn +68,67.91317,republican,Upshur,22,,,20,18910,2,18612,55,93,15437,27955,2797,5172,319,536,12,38,12518,2375,217,4
unknown,1421.0,Released as a precinct as first report of the night,,1035,84,84% reported,edison,84%,48461,2020-11-04T10:43:53Z,R+74,Cornyn +74,73.96849,republican,Upton,5,,,4,1591,2,1333,11,20,1145,2032,159,284,18,32,0,9,887,125,14,0
unknown,10291.0,Released as a precinct as first report of the night,,7991,86,86% reported,edison,86%,48463,2020-11-04T10:43:54Z,R+21,Cornyn +21,21.29013,republican,Uvalde,14,,,12,11653,2,10061,99,166,5955,10474,3813,7069,192,339,6,67,4519,3256,147,2
some,12685.0,Released as a precinct as first report of the night,,11759,80,80% reported,edison,80%,48465,2020-11-04T10:43:55Z,R+10,Cornyn +10,10.32891,republican,Val Verde,17,,,14,17702,4,14077,164,273,7567,13847,6113,11309,220,382,38,109,6280,5196,162,12
unknown,15091.0,Released as a precinct as first report of the night,,17038,99,>98% reported,edison,>98%,48467,2020-11-04T10:43:58Z,R+73,Cornyn +73,72.73938,republican,Van Zandt,19,,,17,25850,2,25535,106,157,21861,36407,3287,5566,281,443,0,51,14546,2279,162,0
unknown,29340.0,Released as a precinct as first report of the night,,27580,92,92% reported,edison,92%,48469,2020-11-04T20:34:53Z,R+40,Cornyn +40,39.52901,republican,Victoria,35,,,29,36753,2,33674,172,297,23136,41966,9825,18076,523,897,36,125,18830,8251,374,0
unknown,16785.0,Released as a precinct as first report of the night,,19360,99,>98% reported,edison,>98%,48471,2020-11-04T10:43:59Z,R+34,Cornyn +34,34.36422,republican,Walker,17,,,16,23641,6,23475,133,229,15473,28134,7406,13682,447,761,45,96,12661,6276,314,13
some,15909.0,Released as a precinct as first report of the night,,18981,100,>98% reported,edison,>98%,48473,2020-11-04T10:44:00Z,R+29,Cornyn +29,29.04453,republican,Waller,21,,,21,19820,2,22345,119,203,14162,26289,7672,14160,392,674,0,84,12127,6488,282,0
unknown,3020.0,Released as a precinct as first report of the night,,3038,97,97% reported,edison,97%,48475,2020-11-04T10:44:01Z,R+61,Cornyn +61,61.29032,republican,Ward,9,,,8,4069,2,3937,16,27,3136,5576,723,1270,61,100,3,11,2440,547,39,1
unknown,15246.0,Released as a precinct as first report of the night,,14399,94,94% reported,edison,94%,48477,2020-11-04T10:44:02Z,R+52,Cornyn +52,51.93165,republican,Washington,22,,,20,18306,2,17265,51,86,12979,23742,4013,7457,221,377,3,35,10763,3444,156,1
some,48936.0,Released as a precinct as first report of the night,,51881,90,90% reported,edison,90%,48479,2020-11-05T08:29:49Z,D+27,Hegar +27,26.61275,democrat,Webb,70,,,62,73977,2,66393,1103,1835,23153,41038,40822,73126,1246,2160,184,732,17885,32304,914,46
unknown,14576.0,Released as a precinct as first report of the night,,14385,95,95% reported,edison,95%,48481,2020-11-04T10:49:54Z,R+44,Cornyn +44,44.14126,republican,Wharton,13,,,11,17397,2,16565,69,127,11802,22199,4490,8256,203,367,2,58,10397,3766,164,0
unknown,1640.0,Released as a precinct as first report of the night,,1598,84,84% reported,edison,84%,48483,2020-11-04T10:44:05Z,R+84,Cornyn +84,83.91057,republican,Wheeler,11,,,8,2723,2,2281,11,17,2079,3536,165,283,26,43,0,6,1457,118,17,0
some,45995.0,Released as a precinct as first report of the night,,37127,89,89% reported,edison,89%,48485,2020-11-06T04:11:49Z,R+43,Cornyn +43,42.6794,republican,Wichita,62,,,56,50639,2,45010,256,436,31488,57630,12278,22393,988,1678,0,180,26142,10115,690,0
unknown,4072.0,Released as a precinct as first report of the night,,3664,91,91% reported,edison,91%,48487,2020-11-04T10:44:08Z,R+59,Cornyn +59,58.84886,republican,Wilbarger,5,,,4,4848,2,4413,18,29,3469,6376,872,1575,54,97,0,11,2907,703,43,0
unknown,3321.0,Released as a precinct as first report of the night,,3408,80,80% reported,edison,80%,48489,2020-11-04T10:44:08Z,D+15,Hegar +15,14.75161,democrat,Willacy,17,,,14,6624,2,5274,53,82,2179,3538,2957,4931,85,131,0,29,1359,1974,46,0
all,172960.0,Released as a precinct as first report of the night,,256610,99,>98% reported,edison,>98%,48491,2020-11-04T10:44:09Z,R+3,Cornyn +3,3.10568,republican,Williamson,58,,,58,285000,4,281549,1472,2662,141319,268036,132575,256322,6065,11004,253,1190,126717,123747,4939,17
unknown,17031.0,Released as a precinct as first report of the night,,20661,100,>98% reported,edison,>98%,48493,2020-11-04T10:44:09Z,R+50,Cornyn +50,50.15796,republican,Wilson,17,,,17,22948,2,24690,118,206,18324,33501,5940,11104,308,540,0,88,15177,5164,232,0
unknown,1480.0,Released as a precinct as first report of the night,,1447,86,86% reported,edison,86%,48495,2020-11-04T10:44:09Z,R+66,Cornyn +66,65.71156,republican,Winkler,6,,,5,2439,2,2094,12,18,1714,2886,338,589,30,48,0,6,1172,251,18,0
unknown,19355.0,Released as a precinct as first report of the night,,27070,100,>98% reported,edison,>98%,48497,2020-11-04T10:44:10Z,R+69,Cornyn +69,68.78993,republican,Wise,26,,,26,29258,2,31932,162,275,26587,49192,4621,8553,562,982,0,113,22605,3932,420,0
unknown,14753.0,Released as a precinct as first report of the night,,19189,100,>98% reported,edison,>98%,48499,2020-11-04T10:44:10Z,R+69,Cornyn +69,68.77013,republican,Wood,14,,,13,22115,2,22360,85,149,18673,34658,3296,6206,306,536,0,64,15985,2910,230,0
unknown,2155.0,Released as a precinct as first report of the night,,2105,87,87% reported,edison,87%,48501,2020-11-04T10:44:10Z,R+68,Cornyn +68,67.98921,republican,Yoakum,7,,,6,2994,2,2596,21,36,2151,3929,386,670,38,66,0,15,1778,284,28,0
unknown,9164.0,Released as a precinct as first report of the night,,6992,89,89% reported,edison,89%,48503,2020-11-04T10:44:11Z,R+74,Cornyn +74,74.316,republican,Young,10,,,8,9101,2,8114,26,46,6999,13054,969,1792,120,214,0,20,6055,823,94,0
unknown,3125.0,Released as a precinct as first report of the night,,2172,73,73% reported,edison,73%,48505,2020-11-04T10:44:11Z,D+11,Hegar +11,10.77151,democrat,Zapata,8,,,7,4606,2,3370,50,73,1453,2384,1816,3008,51,77,0,23,931,1192,26,0
unknown,3597.0,Released as a precinct as first report of the night,,2756,84,84% reported,edison,84%,48507,2020-11-04T10:44:12Z,D+35,Hegar +35,35.07762,democrat,Zavala,6,,,5,4749,2,3994,57,86,1232,1983,2633,4573,72,108,0,29,751,1940,36,0
