absentee_count_progress,absentee_max_ballots,absentee_method,absentee_outstanding,absentee_votes,eevp,eevp_display,eevp_source,eevp_value,fips,last_updated,leader_margin_display,leader_margin_name_display,leader_margin_value,leader_party_id,name,precincts,provisional_count_progress,provisional_outstanding,reporting,tot_exp_vote,turnout_stage,votes,bidenj__total_count,democrat__total_count,hawkinsh__total_count,green__total_count,jorgensenj__total_count,libertarian__total_count,trumpd__total_count,republican__total_count,write-ins__total_count,bidenj__absentee_count,hawkinsh__absentee_count,jorgensenj__absentee_count,trumpd__absentee_count,write-ins__absentee_count
none,15380.0,Released as a precinct as first report of the night,,14459,96,96% reported,edison,96%,48001,2020-11-04T10:44:02Z,R+58,Trump +58,58.09449,republican,Anderson,23,,,20,20048,2,19155,3934,7168,22,43,132,228,15062,26165,15,3234,21,96,11103,5
unknown,4805.0,Released as a precinct as first report of the night,,4776,100,>98% reported,edison,>98%,48003,2020-11-04T10:44:05Z,R+70,Trump +70,69.80874,republican,Andrews,5,,,5,5837,2,5856,849,1549,10,16,60,105,4937,8962,0,700,6,45,4025,0
unknown,28954.0,Released as a precinct as first report of the night,,28676,98,98% reported,edison,98%,48005,2020-11-04T10:44:07Z,R+46,Trump +46,46.01479,republican,Angelina,43,,,38,35322,2,34628,9136,16849,75,129,273,472,25070,45725,203,7713,54,199,20655,55
unknown,10783.0,Released as a precinct as first report of the night,,10983,99,>98% reported,edison,>98%,48007,2020-11-04T10:44:07Z,R+52,Trump +52,51.58075,republican,Aransas,6,,,5,12414,2,12241,2896,5549,31,57,103,187,9210,17430,2,2653,26,84,8220,0
unknown,2737.0,Released as a precinct as first report of the night,,3623,91,91% reported,edison,91%,48009,2020-11-04T10:44:08Z,R+80,Trump +80,80.35863,republican,Archer,12,,,10,5288,2,4796,446,802,4,6,45,73,4300,7536,3,356,2,28,3236,1
unknown,777.0,Released as a precinct as first report of the night,,846,88,88% reported,edison,88%,48011,2020-11-04T10:44:09Z,R+86,Trump +86,86.33094,republican,Armstrong,8,,,7,1260,2,1112,75,136,0,0,2,3,1035,1819,0,61,0,1,784,0
unknown,10647.0,Released as a precinct as first report of the night,,14759,100,>98% reported,edison,>98%,48013,2020-11-04T10:44:09Z,R+34,Trump +34,34.03373,republican,Atascosa,25,,,25,17775,2,18085,5865,10707,58,102,142,254,12020,21781,0,4842,44,112,9761,0
some,9966.0,Released as a precinct as first report of the night,,11550,95,95% reported,edison,95%,48015,2020-11-04T10:44:09Z,R+58,Trump +58,58.12222,republican,Austin,18,,,16,15153,2,14368,2931,5367,33,59,122,213,11282,20279,0,2436,26,91,8997,0
unknown,1464.0,Released as a precinct as first report of the night,,1282,79,79% reported,edison,79%,48017,2020-11-04T10:44:10Z,R+55,Trump +55,55.17799,republican,Bailey,5,,,4,2361,2,1854,407,660,2,2,14,21,1430,2451,3,253,0,7,1021,1
unknown,10011.0,Released as a precinct as first report of the night,,11074,100,>98% reported,edison,>98%,48019,2020-11-04T10:44:10Z,R+59,Trump +59,59.41116,republican,Bandera,11,,,11,12614,2,12703,2503,4798,30,52,120,212,10050,18715,0,2295,22,92,8665,0
unknown,25791.0,Released as a precinct as first report of the night,,31298,100,>98% reported,edison,>98%,48021,2020-11-04T10:44:10Z,R+14,Trump +14,13.71326,republican,Bastrop,23,,,23,33601,2,36709,15452,29342,128,235,530,936,20486,37367,240,13890,107,406,16881,14
unknown,1554.0,Released as a precinct as first report of the night,,1373,89,89% reported,edison,89%,48023,2020-11-04T10:43:29Z,R+77,Trump +77,77.32143,republican,Baylor,5,,,4,1880,2,1680,179,324,1,2,22,38,1478,2689,0,145,1,16,1211,0
unknown,7301.0,Released as a precinct as first report of the night,,7536,94,94% reported,edison,94%,48025,2020-11-04T10:43:29Z,R+29,Trump +29,28.91015,republican,Bee,18,,,15,10020,2,9405,3280,6033,27,48,93,161,5999,10687,18,2753,21,68,4688,6
some,89466.0,Released as a precinct as first report of the night,,102935,100,>98% reported,edison,>98%,48027,2020-11-04T10:43:30Z,R+9,Trump +9,8.80374,republican,Bell,49,,,49,117276,4,125867,56032,103912,430,748,1940,3243,67113,120517,734,47880,318,1303,53404,30
all,609654.0,Released as a precinct as first report of the night,,674018,99,>98% reported,edison,>98%,48029,2020-11-04T10:43:32Z,D+18,Biden +18,18.07549,democrat,Bexar,767,,,756,766539,2,757667,440823,838161,2752,4989,8575,15428,303871,570016,4737,397338,2237,6853,266145,1445
unknown,4204.0,Released as a precinct as first report of the night,,6432,100,>98% reported,edison,>98%,48031,2020-11-04T10:43:34Z,R+47,Trump +47,47.49966,republican,Blanco,7,,,7,7019,2,7419,1905,3657,15,26,70,126,5429,10042,0,1752,11,56,4613,0
unknown,320.0,Released as a precinct as first report of the night,,306,87,87% reported,edison,87%,48033,2020-11-04T10:43:35Z,R+92,Trump +92,91.99029,republican,Borden,8,,,7,475,2,412,16,27,0,0,1,2,395,689,0,11,0,1,294,0
unknown,4229.0,Released as a precinct as first report of the night,,6535,98,98% reported,edison,98%,48035,2020-11-04T10:43:36Z,R+65,Trump +65,64.81196,republican,Bosque,12,,,11,9256,2,9094,1552,2753,13,23,83,133,7446,12720,0,1201,10,50,5274,0
all,32487.0,Released as a precinct as first report of the night,,30019,91,91% reported,edison,91%,48037,2020-11-04T10:43:37Z,R+43,Trump +43,42.83657,republican,Bowie,43,,,37,41804,4,38194,10692,19845,90,158,297,495,27053,47608,169,9153,68,198,20555,45
some,131649.0,Released as a precinct as first report of the night,,139447,100,>98% reported,edison,>98%,48039,2020-11-04T10:43:38Z,R+18,Trump +18,18.28067,republican,Brazoria,67,,,66,149605,2,154037,61780,118529,417,762,1856,3350,89939,170761,127,56749,345,1494,80822,37
all,57474.0,Released as a precinct as first report of the night,,71847,100,>98% reported,edison,>98%,48041,2020-11-04T10:43:40Z,R+14,Trump +14,14.41129,republican,Brazos,99,,,96,84753,6,84753,35242,65778,252,415,1803,3098,47456,87309,0,30536,163,1295,39853,0
all,4467.0,Released as a precinct as first report of the night,,3978,100,>98% reported,edison,>98%,48043,2020-11-04T10:43:41Z,R+4,Trump +4,4.16233,republican,Brewster,9,,,8,4805,6,4805,2251,4167,14,23,89,157,2451,4436,0,1916,9,68,1985,0
unknown,503.0,Released as a precinct as first report of the night,,452,76,76% reported,edison,76%,48045,2020-11-04T10:43:43Z,R+78,Trump +78,77.62431,republican,Briscoe,6,,,5,957,2,724,77,128,1,1,7,12,639,1035,0,51,0,5,396,0
unknown,1853.0,Released as a precinct as first report of the night,,1821,74,74% reported,edison,74%,48047,2020-11-04T10:43:44Z,D+19,Biden +19,19.00161,democrat,Brooks,6,,,4,3375,2,2484,1470,2629,6,11,10,17,998,1648,0,1159,5,7,650,0
some,14372.0,Released as a precinct as first report of the night,,12544,96,96% reported,edison,96%,48049,2020-11-04T10:43:44Z,R+73,Trump +73,72.63488,republican,Brown,19,,,17,16564,2,15940,2103,3807,24,39,132,212,13681,24426,0,1704,15,80,10745,0
unknown,5572.0,Released as a precinct as first report of the night,,6680,100,>98% reported,edison,>98%,48051,2020-11-04T10:43:45Z,R+58,Trump +58,57.57787,republican,Burleson,14,,,13,8219,2,8604,1786,3237,15,28,63,97,6740,11922,0,1451,13,34,5182,0
unknown,17630.0,Released as a precinct as first report of the night,,20840,100,>98% reported,edison,>98%,48053,2020-11-04T10:43:46Z,R+53,Trump +53,53.17699,republican,Burnet,21,,,21,23708,2,24646,5615,10547,34,59,266,469,18721,34394,27,4932,25,203,15673,7
unknown,10580.0,Released as a precinct as first report of the night,,12320,100,>98% reported,edison,>98%,48055,2020-11-04T10:43:47Z,R+10,Trump +10,9.73942,republican,Caldwell,32,,,30,14280,2,14775,6536,12086,46,77,185,326,7975,14552,87,5550,31,141,6577,21
unknown,5674.0,Released as a precinct as first report of the night,,5695,95,95% reported,edison,95%,48057,2020-11-04T10:43:49Z,R+44,Trump +44,44.49255,republican,Calhoun,26,,,23,8225,2,7853,2146,3915,6,11,61,104,5640,9518,0,1769,5,43,3878,0
unknown,4184.0,Released as a precinct as first report of the night,,5495,100,>98% reported,edison,>98%,48059,2020-11-04T10:43:50Z,R+77,Trump +77,77.2341,republican,Callahan,8,,,8,6589,2,6826,734,1357,15,25,71,114,6006,10825,0,623,10,43,4819,0
some,71585.0,Released as a precinct as first report of the night,,95867,95,95% reported,edison,95%,48061,2020-11-04T10:44:53Z,D+13,Biden +13,13.09265,democrat,Cameron,104,,,99,119703,4,113789,63732,118324,334,609,725,1299,48834,89137,451,54592,275,574,40303,123
unknown,4295.0,Released as a precinct as first report of the night,,4296,94,94% reported,edison,94%,48063,2020-11-04T10:43:52Z,R+44,Trump +44,44.17639,republican,Camp,5,,,4,5364,2,5057,1392,2539,7,12,31,55,3626,6745,3,1147,5,24,3119,1
unknown,1767.0,Released as a precinct as first report of the night,,1895,84,84% reported,edison,84%,48065,2020-11-04T10:43:53Z,R+80,Trump +80,79.77929,republican,Carson,9,,,7,3659,2,3081,289,505,3,5,36,59,2747,4396,17,216,2,23,1649,5
unknown,8478.0,Released as a precinct as first report of the night,,10773,95,95% reported,edison,95%,48067,2020-11-04T10:43:54Z,R+59,Trump +59,59.19457,republican,Cass,19,,,16,14577,2,13856,2777,5058,17,27,79,135,10979,19403,10,2281,10,56,8424,2
unknown,1417.0,Released as a precinct as first report of the night,,1106,76,76% reported,edison,76%,48069,2020-11-04T10:43:54Z,R+55,Trump +55,54.51489,republican,Castro,9,,,7,2755,2,2082,466,735,6,7,9,11,1601,2435,0,269,1,2,834,0
some,17808.0,Released as a precinct as first report of the night,,19074,100,>98% reported,edison,>98%,48071,2020-11-04T10:43:56Z,R+62,Trump +62,61.66998,republican,Chambers,15,,,15,19823,2,21641,3997,7454,49,83,250,451,17343,32723,6,3457,34,201,15380,2
unknown,16073.0,Released as a precinct as first report of the night,,15460,98,98% reported,edison,98%,48073,2020-11-04T10:43:58Z,R+56,Trump +56,55.86164,republican,Cherokee,25,,,22,19827,2,19457,4196,7698,36,60,160,276,15065,26883,0,3502,24,116,11818,0
unknown,1817.0,Released as a precinct as first report of the night,,1785,92,92% reported,edison,92%,48075,2020-11-04T10:43:59Z,R+72,Trump +72,71.84595,republican,Childress,5,,,4,2461,2,2259,305,549,8,12,18,30,1928,3453,0,244,4,12,1525,0
unknown,3005.0,Released as a precinct as first report of the night,,4166,96,96% reported,edison,96%,48077,2020-11-04T10:44:00Z,R+78,Trump +78,77.5802,republican,Clay,17,,,14,5971,2,5736,614,1088,12,17,46,74,5064,8723,0,474,5,28,3659,0
unknown,604.0,Released as a precinct as first report of the night,,676,84,84% reported,edison,84%,48079,2020-11-04T10:44:01Z,R+63,Trump +63,63.25301,republican,Cochran,4,,,3,1192,2,996,176,294,3,6,11,16,806,1356,0,118,3,5,550,0
unknown,1206.0,Released as a precinct as first report of the night,,1278,100,>98% reported,edison,>98%,48081,2020-11-04T10:44:01Z,R+75,Trump +75,75.25084,republican,Coke,5,,,5,1681,2,1794,215,383,5,7,9,13,1565,2669,0,168,2,4,1104,0
some,3691.0,Released as a precinct as first report of the night,,3553,96,96% reported,edison,96%,48083,2020-11-06T13:36:10Z,R+77,Trump +77,77.25291,republican,Coleman,5,,,4,4302,2,4128,451,845,9,16,23,42,3640,6768,15,394,7,19,3128,5
unknown,368567.0,Released as a precinct as first report of the night,,469632,100,>98% reported,edison,>98%,48085,2020-11-04T10:44:02Z,R+5,Trump +5,4.58518,republican,Collin,240,,,240,486391,6,486917,227868,453624,1223,2275,6038,11194,250194,486501,4549,225756,1052,5156,236307,1361
unknown,1021.0,Released as a precinct as first report of the night,,845,89,89% reported,edison,89%,48087,2020-11-04T10:44:04Z,R+73,Trump +73,73.31691,republican,Collingsworth,8,,,6,1365,2,1218,155,267,1,2,12,20,1048,1772,4,112,1,8,724,0
some,6404.0,Released as a precinct as first report of the night,,8022,99,>98% reported,edison,>98%,48089,2020-11-06T20:29:31Z,R+51,Trump +51,50.81719,republican,Colorado,5,,,4,10053,2,9912,2403,4479,19,33,49,87,7440,13334,2,2076,14,38,5894,0
unknown,64101.0,Released as a precinct as first report of the night,,79588,100,>98% reported,edison,>98%,48091,2020-11-04T10:44:07Z,R+43,Trump +43,43.08635,republican,Comal,30,,,30,87942,6,87942,24369,46826,190,345,1094,1937,62260,118371,80,22457,155,843,56111,22
unknown,4034.0,Released as a precinct as first report of the night,,4680,98,98% reported,edison,98%,48093,2020-11-04T10:44:08Z,R+71,Trump +71,71.0881,republican,Comanche,15,,,13,6184,2,6084,852,1538,5,7,49,75,5177,9142,3,686,2,26,3965,1
unknown,569.0,Released as a precinct as first report of the night,,783,100,>98% reported,edison,>98%,48095,2020-11-04T10:44:08Z,R+68,Trump +68,67.90221,republican,Concho,9,,,8,1261,2,1268,197,335,3,5,10,17,1058,1694,0,138,2,7,636,0
some,10395.0,Released as a precinct as first report of the night,,13661,100,>98% reported,edison,>98%,48097,2020-11-04T10:44:09Z,R+65,Trump +65,65.1366,republican,Cooke,30,,,27,18842,2,18997,3205,5760,26,45,156,256,15579,26535,93,2555,19,100,10956,31
some,16701.0,Released as a precinct as first report of the night,,19277,100,>98% reported,edison,>98%,48099,2020-11-04T10:44:09Z,R+34,Trump +34,33.53255,republican,Coryell,16,,,16,21555,2,23425,7542,14021,77,134,406,691,15397,27850,9,6479,57,285,12453,3
unknown,690.0,Released as a precinct as first report of the night,,492,69,69% reported,edison,69%,48101,2020-11-04T10:44:09Z,R+65,Trump +65,64.66165,republican,Cottle,5,,,4,963,2,665,113,201,3,4,6,10,543,942,0,88,1,4,399,0
unknown,1280.0,Released as a precinct as first report of the night,,1086,84,84% reported,edison,84%,48103,2020-11-04T10:44:10Z,R+67,Trump +67,66.9328,republican,Crane,4,,,3,1799,2,1503,241,411,4,6,10,17,1247,2153,3,170,2,7,906,1
unknown,1379.0,Released as a precinct as first report of the night,,1212,83,83% reported,edison,83%,48105,2020-11-04T10:44:10Z,R+56,Trump +56,55.62619,republican,Crockett,5,,,4,1894,2,1573,344,613,1,1,9,13,1219,2158,0,269,0,4,939,0
unknown,1368.0,Released as a precinct as first report of the night,,1221,93,93% reported,edison,93%,48107,2020-11-04T10:44:10Z,R+44,Trump +44,44.49565,republican,Crosby,5,,,4,2110,2,1953,527,864,8,12,22,34,1396,2264,0,337,4,12,868,0
unknown,681.0,Released as a precinct as first report of the night,,558,76,76% reported,edison,76%,48109,2020-11-04T10:44:11Z,D+3,Biden +3,2.66204,democrat,Culberson,6,,,5,1143,2,864,438,735,2,3,9,13,415,671,0,297,1,4,256,0
unknown,954.0,Released as a precinct as first report of the night,,1029,88,88% reported,edison,88%,48111,2020-11-04T10:44:11Z,R+74,Trump +74,74.1433,republican,Dallam,10,,,8,1823,2,1605,196,324,5,9,18,26,1386,2275,0,128,4,8,889,0
all,739551.0,Released as a precinct as first report of the night,,800089,93,93% reported,edison,93%,48113,2020-11-07T20:14:47Z,D+32,Biden +32,31.61977,democrat,Dallas,1170,,,1092,986665,4,920772,597975,1124050,3661,6392,9623,16873,306829,568178,8052,526075,2731,7250,261349,2684
unknown,3346.0,Released as a precinct as first report of the night,,2918,88,88% reported,edison,88%,48115,2020-11-04T10:44:12Z,R+57,Trump +57,56.55846,republican,Dawson,10,,,8,4301,2,3789,808,1397,5,9,25,43,2951,5258,0,589,4,18,2307,0
unknown,5965.0,Released as a precinct as first report of the night,,6229,100,>98% reported,edison,>98%,48123,2020-11-04T10:44:14Z,R+62,Trump +62,62.49076,republican,De Witt,10,,,9,8082,2,8118,1494,2681,11,18,46,81,6567,11567,0,1187,7,35,5000,0
unknown,739.0,Released as a precinct as first report of the night,,3634,82,82% reported,edison,82%,48117,2020-11-04T10:44:13Z,R+44,Trump +44,44.05382,republican,Deaf Smith,5,,,4,5602,2,4608,1263,2188,17,31,35,58,3293,5965,0,925,14,23,2672,0
unknown,1505.0,Released as a precinct as first report of the night,,1829,96,96% reported,edison,96%,48119,2020-11-04T10:44:13Z,R+68,Trump +68,67.80054,republican,Delta,8,,,7,2693,2,2587,403,730,3,5,24,39,2157,3642,0,327,2,15,1485,0
all,280830.0,Released as a precinct as first report of the night,,382980,100,>98% reported,edison,>98%,48121,2020-11-04T10:44:14Z,R+8,Trump +8,8.11454,republican,Denton,186,,,186,416610,6,416610,188023,362596,1089,2003,5395,9919,221829,424561,785,174573,914,4524,202732,237
unknown,846.0,Released as a precinct as first report of the night,,676,74,74% reported,edison,74%,48125,2020-11-04T10:44:14Z,R+73,Trump +73,73.09645,republican,Dickens,7,,,6,1325,2,985,130,217,2,3,3,5,850,1436,0,87,1,2,586,0
unknown,2084.0,Released as a precinct as first report of the night,,2455,87,87% reported,edison,87%,48127,2020-11-04T10:44:15Z,D+24,Biden +24,24.00436,democrat,Dimmit,8,,,7,4193,2,3666,2264,3856,8,11,10,18,1384,2236,0,1592,3,8,852,0
unknown,1330.0,Released as a precinct as first report of the night,,1158,91,91% reported,edison,91%,48129,2020-11-04T10:44:15Z,R+75,Trump +75,75.24272,republican,Donley,7,,,6,1811,2,1648,198,341,1,1,11,17,1438,2447,0,143,0,6,1009,0
unknown,4122.0,Released as a precinct as first report of the night,,5050,89,89% reported,edison,89%,48131,2020-11-04T10:44:15Z,D+3,Biden +3,2.59406,democrat,Duval,10,,,9,5647,2,5050,2573,5146,13,26,22,44,2442,4884,0,2573,13,22,2442,0
unknown,5907.0,Released as a precinct as first report of the night,,6521,100,>98% reported,edison,>98%,48133,2020-11-04T10:44:15Z,R+75,Trump +75,75.37178,republican,Eastland,10,,,9,8223,2,8271,982,1774,12,22,60,95,7216,12899,3,792,10,35,5683,1
unknown,35298.0,Released as a precinct as first report of the night,,35430,100,>98% reported,edison,>98%,48135,2020-11-04T10:44:16Z,R+48,Trump +48,47.90058,republican,Ector,41,,,38,43138,2,44417,11310,20521,89,145,428,720,32586,58453,12,9211,56,292,25867,4
unknown,827.0,Released as a precinct as first report of the night,,773,84,84% reported,edison,84%,48137,2020-11-04T10:44:16Z,R+68,Trump +68,68.32707,republican,Edwards,5,,,4,1267,2,1064,166,291,0,0,5,7,893,1539,0,125,0,2,646,0
some,157724.0,Released as a precinct as first report of the night,,208372,92,92% reported,edison,92%,48141,2020-11-04T10:44:16Z,D+34,Biden +34,34.3968,democrat,El Paso,209,,,191,278210,2,254576,168801,310012,1401,2418,2592,4481,81235,145490,1094,141211,1017,1889,64255,0
all,56843.0,Released as a precinct as first report of the night,,75249,100,>98% reported,edison,>98%,48139,2020-11-04T10:44:16Z,R+34,Trump +34,34.05325,republican,Ellis,50,,,50,85566,6,85566,27513,52016,220,388,951,1685,56651,106298,659,24503,168,734,49647,197
unknown,13085.0,Released as a precinct as first report of the night,,13626,98,98% reported,edison,98%,48143,2020-11-04T10:44:16Z,R+64,Trump +64,63.87718,republican,Erath,22,,,21,17152,2,16837,2914,5321,35,61,217,381,13669,24697,5,2407,26,164,11028,1
unknown,3515.0,Released as a precinct as first report of the night,,3683,96,96% reported,edison,96%,48145,2020-11-04T20:56:56Z,R+37,Trump +37,37.14332,republican,Falls,13,,,11,6415,2,6133,1899,3205,13,21,44,71,4177,6519,0,1306,8,27,2342,0
unknown,8408.0,Released as a precinct as first report of the night,,11041,100,>98% reported,edison,>98%,48147,2020-11-04T10:44:17Z,R+64,Trump +64,63.54466,republican,Fannin,17,,,16,14223,2,14969,2638,4762,23,39,155,249,12150,20954,9,2124,16,94,8804,3
unknown,7646.0,Released as a precinct as first report of the night,,9289,98,98% reported,edison,98%,48149,2020-11-04T10:44:17Z,R+58,Trump +58,58.13216,republican,Fayette,27,,,24,13195,2,12924,2650,4682,26,43,83,136,10163,17348,6,2032,17,53,7185,2
unknown,1044.0,Released as a precinct as first report of the night,,1304,89,89% reported,edison,89%,48151,2020-11-04T10:44:17Z,R+60,Trump +60,60.02191,republican,Fisher,5,,,4,2042,2,1826,352,614,5,8,21,38,1448,2470,0,262,3,17,1022,0
unknown,2191.0,Released as a precinct as first report of the night,,1663,83,83% reported,edison,83%,48153,2020-11-04T10:44:17Z,R+56,Trump +56,56.21622,republican,Floyd,7,,,6,2463,2,2035,437,776,2,4,15,23,1581,2895,0,339,2,8,1314,0
unknown,398.0,Released as a precinct as first report of the night,,412,83,83% reported,edison,83%,48155,2020-11-04T10:44:17Z,R+63,Trump +63,62.79492,republican,Foard,5,,,4,667,2,551,99,175,1,2,6,9,445,777,0,76,1,3,332,0
unknown,267057.0,Released as a precinct as first report of the night,,327278,100,>98% reported,edison,>98%,48157,2020-11-04T23:45:55Z,D+11,Biden +11,10.50658,democrat,Fort Bend,160,,,160,340686,2,357833,195191,375388,1089,1992,3019,5574,157595,301218,1878,180197,903,2555,143623,0
unknown,3878.0,Released as a precinct as first report of the night,,3938,92,92% reported,edison,92%,48159,2020-11-04T10:44:17Z,R+67,Trump +67,67.0,republican,Franklin,9,,,8,5407,2,5000,803,1464,8,15,36,60,4153,7399,0,661,7,24,3246,0
unknown,7301.0,Released as a precinct as first report of the night,,6531,96,96% reported,edison,96%,48161,2020-11-04T10:44:18Z,R+62,Trump +62,61.50035,republican,Freestone,16,,,14,9074,2,8678,1629,2942,18,28,65,98,6966,12141,0,1313,10,33,5175,0
some,2129.0,Released as a precinct as first report of the night,,3707,92,92% reported,edison,92%,48163,2020-11-04T10:44:18Z,R+7,Trump +7,7.42781,republican,Frio,10,,,9,5720,2,5264,2421,4246,8,14,23,34,2812,4677,0,1825,6,11,1865,0
unknown,3944.0,Released as a precinct as first report of the night,,5217,100,>98% reported,edison,>98%,48165,2020-11-04T10:44:18Z,R+80,Trump +80,79.71477,republican,Gaines,9,,,9,5456,2,5960,572,1035,10,17,54,91,5323,10032,3,463,7,37,4709,1
unknown,137290.0,Released as a precinct as first report of the night,,139837,100,>98% reported,edison,>98%,48167,2020-11-04T10:44:18Z,R+23,Trump +23,22.78882,republican,Galveston,93,,,90,151732,2,153843,58247,111573,391,701,1899,3432,93306,177974,0,53326,310,1533,84668,0
unknown,1568.0,Released as a precinct as first report of the night,,1235,90,90% reported,edison,90%,48169,2020-11-04T10:44:18Z,R+71,Trump +71,71.47184,republican,Garza,7,,,6,1842,2,1651,231,400,4,8,5,9,1411,2469,0,169,4,4,1058,0
unknown,13119.0,Released as a precinct as first report of the night,,12665,94,94% reported,edison,94%,48171,2020-11-04T10:44:18Z,R+59,Trump +59,58.99981,republican,Gillespie,14,,,13,16761,2,15817,3163,5962,16,28,139,244,12495,22242,10,2799,12,105,9747,2
unknown,495.0,Released as a precinct as first report of the night,,487,83,83% reported,edison,83%,48173,2020-11-04T10:43:28Z,R+88,Trump +88,87.59571,republican,Glasscock,5,,,4,785,2,653,39,71,0,0,3,4,611,1065,0,32,0,1,454,0
unknown,3358.0,Released as a precinct as first report of the night,,2901,91,91% reported,edison,91%,48175,2020-11-04T10:43:28Z,R+56,Trump +56,55.53042,republican,Goliad,10,,,8,4378,2,3978,872,1548,2,3,23,35,3081,5293,0,676,1,12,2212,0
unknown,5788.0,Released as a precinct as first report of the night,,6010,100,>98% reported,edison,>98%,48177,2020-11-04T10:43:28Z,R+49,Trump +49,48.7656,republican,Gonzales,16,,,15,7480,2,7534,1894,3426,14,24,57,94,5568,9998,3,1532,10,37,4430,1
unknown,7277.0,Released as a precinct as first report of the night,,5742,89,89% reported,edison,89%,48179,2020-11-04T10:43:29Z,R+77,Trump +77,77.36604,republican,Gray,8,,,6,8745,2,7745,820,1453,16,28,97,162,6812,11844,0,633,12,65,5032,0
unknown,43337.0,Released as a precinct as first report of the night,,50301,100,>98% reported,edison,>98%,48181,2020-11-04T10:43:30Z,R+50,Trump +50,50.29442,republican,Grayson,37,,,35,55994,2,58760,14223,26734,136,222,625,1085,43776,81020,0,12511,86,460,37244,0
all,51605.0,Released as a precinct as first report of the night,,42687,97,97% reported,edison,97%,48183,2020-11-04T10:43:32Z,R+37,Trump +37,37.09644,republican,Gregg,22,,,19,49302,4,47700,14657,27759,113,205,550,974,32352,61400,77,13102,92,424,29048,21
unknown,7009.0,Released as a precinct as first report of the night,,9508,100,>98% reported,edison,>98%,48185,2020-11-04T10:43:33Z,R+53,Trump +53,53.1376,republican,Grimes,15,,,15,11258,2,12398,2831,5107,29,49,118,187,9419,16561,3,2276,20,69,7142,1
some,55597.0,Released as a precinct as first report of the night,,68026,100,>98% reported,edison,>98%,48187,2020-11-04T10:43:34Z,R+24,Trump +24,24.1878,republican,Guadalupe,72,,,72,71385,2,77382,28706,54483,211,377,1016,1797,47423,88702,75,25777,166,781,41279,23
unknown,8534.0,Released as a precinct as first report of the night,,7496,91,91% reported,edison,91%,48189,2020-11-04T10:43:35Z,R+51,Trump +51,51.16109,republican,Hale,31,,,26,10460,2,9560,2271,3958,31,53,96,161,7162,12884,0,1687,22,65,5722,0
unknown,871.0,Released as a precinct as first report of the night,,808,89,89% reported,edison,89%,48191,2020-11-04T10:43:36Z,R+71,Trump +71,70.81545,republican,Hall,5,,,4,1308,2,1165,167,287,1,1,4,7,992,1676,3,120,0,3,684,1
unknown,3191.0,Released as a precinct as first report of the night,,3304,100,>98% reported,edison,>98%,48193,2020-11-04T10:43:37Z,R+68,Trump +68,68.36899,republican,Hamilton,12,,,11,4275,2,4347,641,1150,40,77,52,92,3613,6330,3,509,37,40,2717,1
unknown,1429.0,Released as a precinct as first report of the night,,1363,88,88% reported,edison,88%,48195,2020-11-04T10:43:38Z,R+82,Trump +82,82.20919,republican,Hansford,8,,,6,2317,2,2046,166,276,3,5,27,40,1848,3085,5,110,2,13,1237,1
unknown,1239.0,Released as a precinct as first report of the night,,1014,88,88% reported,edison,88%,48197,2020-11-04T10:43:39Z,R+69,Trump +69,68.92405,republican,Hardeman,4,,,3,1787,2,1580,241,414,0,0,9,14,1330,2166,0,173,0,5,836,0
unknown,18988.0,Released as a precinct as first report of the night,,22767,100,>98% reported,edison,>98%,48199,2020-11-04T10:43:41Z,R+74,Trump +74,73.8777,republican,Hardin,20,,,19,26901,2,27555,3449,6442,27,44,273,473,23806,43363,0,2993,17,200,19557,0
some,1267589.0,Released as a precinct as first report of the night,,1434022,96,96% reported,edison,96%,48201,2020-11-06T13:56:46Z,D+13,Biden +13,12.98621,democrat,Harris,1013,,,970,1705746,2,1633671,911974,1722080,5097,8968,16761,29749,699822,1306862,51,810106,3871,12988,607040,17
some,29321.0,Released as a precinct as first report of the night,,25555,94,94% reported,edison,94%,48203,2020-11-04T10:43:43Z,R+46,Trump +46,45.8421,republican,Harrison,27,,,23,31350,2,29462,7812,14727,42,78,290,505,21318,39707,0,6915,36,215,18389,0
unknown,1711.0,Released as a precinct as first report of the night,,1622,90,90% reported,edison,90%,48205,2020-11-04T10:43:44Z,R+80,Trump +80,80.49133,republican,Hartley,7,,,6,2305,2,2076,195,346,1,2,14,24,1866,3326,0,151,1,10,1460,0
unknown,1208.0,Released as a precinct as first report of the night,,1374,93,93% reported,edison,93%,48207,2020-11-04T10:43:45Z,R+67,Trump +67,67.11895,republican,Haskell,5,,,5,2374,2,2211,353,586,6,12,15,21,1837,2966,0,233,6,6,1129,0
some,65929.0,Released as a precinct as first report of the night,,98242,100,>98% reported,edison,>98%,48209,2020-11-04T10:43:46Z,D+11,Biden +11,10.83053,democrat,Hays,69,,,69,91536,2,108822,59213,113413,415,740,1729,3124,47427,89716,109,54200,325,1395,42289,33
unknown,1081.0,Released as a precinct as first report of the night,,1175,86,86% reported,edison,86%,48211,2020-11-04T10:43:46Z,R+74,Trump +74,74.4186,republican,Hemphill,9,,,7,2002,2,1720,206,359,3,3,25,40,1486,2493,0,153,0,15,1007,0
unknown,26045.0,Released as a precinct as first report of the night,,29705,100,>98% reported,edison,>98%,48213,2020-11-04T10:43:49Z,R+60,Trump +60,60.13758,republican,Henderson,28,,,26,35481,2,36197,7048,13012,74,120,259,435,28816,52335,0,5964,46,176,23519,0
some,168180.0,Released as a precinct as first report of the night,,187652,98,98% reported,edison,98%,48215,2020-11-06T21:25:58Z,D+17,Biden +17,17.05746,democrat,Hidalgo,256,,,250,225468,2,219939,127507,238347,862,1583,1247,2251,89991,165068,674,110840,721,1004,75077,10
all,8740.0,Released as a precinct as first report of the night,,9632,100,>98% reported,edison,>98%,48217,2020-11-04T10:43:51Z,R+61,Trump +61,60.90413,republican,Hill,22,,,19,14843,6,14843,2829,4862,26,41,119,197,11869,19375,0,2033,15,78,7506,0
unknown,6866.0,Released as a precinct as first report of the night,,6315,94,94% reported,edison,94%,48219,2020-11-04T10:43:52Z,R+62,Trump +62,62.45211,republican,Hockley,15,,,13,8633,2,8091,1481,2638,16,25,60,95,6534,11648,0,1157,9,35,5114,0
some,23816.0,Released as a precinct as first report of the night,,25625,100,>98% reported,edison,>98%,48221,2020-11-06T21:12:16Z,R+64,Trump +64,63.98404,republican,Hood,16,,,16,32582,6,32580,5641,10374,71,120,318,506,26487,47133,135,4733,49,188,20646,9
unknown,12167.0,Released as a precinct as first report of the night,,12965,100,>98% reported,edison,>98%,48223,2020-11-04T10:43:54Z,R+61,Trump +61,60.69546,republican,Hopkins,22,,,20,15987,2,15932,3043,5569,31,58,143,242,12713,23024,6,2526,27,99,10311,2
unknown,7268.0,Released as a precinct as first report of the night,,7088,96,96% reported,edison,96%,48225,2020-11-04T13:46:54Z,R+50,Trump +50,50.26522,republican,Houston,22,,,19,9864,2,9426,2312,4158,7,9,56,95,7050,12251,2,1846,2,39,5201,0
unknown,8479.0,Released as a precinct as first report of the night,,8314,97,97% reported,edison,97%,48227,2020-11-04T10:43:57Z,R+59,Trump +59,58.56816,republican,Howard,27,,,24,10301,2,10043,2017,3728,28,50,88,148,7899,14411,31,1711,22,60,6512,9
unknown,355.0,Released as a precinct as first report of the night,,591,100,>98% reported,edison,>98%,48229,2020-11-04T10:43:58Z,R+35,Trump +35,34.57217,republican,Hudspeth,5,,,5,1132,2,1157,371,559,5,7,10,16,771,1166,0,188,2,6,395,0
unknown,22277.0,Released as a precinct as first report of the night,,28261,100,>98% reported,edison,>98%,48231,2020-11-04T10:59:55Z,R+53,Trump +53,52.58977,republican,Hunt,34,,,31,37262,2,38517,8879,15743,71,112,432,681,29135,50242,0,6864,41,249,21107,0
unknown,7976.0,Released as a precinct as first report of the night,,7006,91,91% reported,edison,91%,48233,2020-11-04T10:44:00Z,R+77,Trump +77,76.67315,republican,Hutchinson,9,,,7,9631,2,8741,957,1729,10,16,113,189,7659,13809,6,772,6,76,6150,2
unknown,640.0,Released as a precinct as first report of the night,,670,87,87% reported,edison,87%,48235,2020-11-04T10:44:01Z,R+72,Trump +72,71.87852,republican,Irion,5,,,4,1024,2,889,120,213,2,4,8,14,759,1328,0,93,2,6,569,0
unknown,2721.0,Released as a precinct as first report of the night,,2941,96,96% reported,edison,96%,48237,2020-11-04T10:44:01Z,R+82,Trump +82,81.60889,republican,Jack,7,,,6,3956,2,3779,331,607,9,15,24,40,3415,6058,0,276,6,16,2643,0
unknown,4125.0,Released as a precinct as first report of the night,,5098,99,>98% reported,edison,>98%,48239,2020-11-04T10:44:02Z,R+66,Trump +66,65.99034,republican,Jackson,10,,,9,6262,2,6210,1018,1850,23,38,51,88,5116,9328,6,832,15,37,4212,2
unknown,13365.0,Released as a precinct as first report of the night,,12707,97,97% reported,edison,97%,48241,2020-11-04T10:44:02Z,R+62,Trump +62,61.71698,republican,Jasper,21,,,19,15961,2,15469,2906,5390,6,10,101,173,12453,22598,8,2484,4,72,10145,2
unknown,1320.0,Released as a precinct as first report of the night,,1039,86,86% reported,edison,86%,48243,2020-11-04T10:44:03Z,R+22,Trump +22,21.62577,republican,Jeff Davis,6,,,5,1510,2,1304,501,910,3,5,17,30,783,1398,0,409,2,13,615,0
all,111555.0,Released as a precinct as first report of the night,,84167,90,90% reported,edison,90%,48245,2020-11-04T10:44:05Z,R+1.6,Trump +1.6,1.59827,republican,Jefferson,140,,,116,104649,2,94665,46022,87199,197,354,891,1578,47535,89663,58,41177,157,687,42128,18
unknown,974.0,Released as a precinct as first report of the night,,1444,74,74% reported,edison,74%,48247,2020-11-04T10:44:07Z,D+18,Biden +18,17.9941,democrat,Jim Hogg,6,,,4,2755,2,2034,1197,2137,2,4,4,6,831,1331,0,940,2,2,500,0
unknown,4321.0,Released as a precinct as first report of the night,,9935,84,84% reported,edison,84%,48249,2020-11-05T14:29:54Z,R+10,Trump +10,10.09847,republican,Jim Wells,22,,,18,16093,2,13507,6025,10642,28,47,65,112,7389,12641,0,4617,19,47,5252,0
all,51853.0,Released as a precinct as first report of the night,,61150,100,>98% reported,edison,>98%,48251,2020-11-04T10:44:08Z,R+53,Trump +53,52.97659,republican,Johnson,36,,,35,71928,6,71928,16418,30742,141,240,767,1352,54523,100627,196,14324,99,585,46104,38
unknown,3234.0,Released as a precinct as first report of the night,,4384,95,95% reported,edison,95%,48253,2020-11-04T10:44:09Z,R+69,Trump +69,69.22732,republican,Jones,12,,,10,7038,2,6691,989,1699,19,31,62,98,5621,9247,0,710,12,36,3626,0
unknown,2303.0,Released as a precinct as first report of the night,,3671,100,>98% reported,edison,>98%,48255,2020-11-04T10:44:09Z,R+52,Trump +52,52.38095,republican,Karnes,15,,,14,4957,2,5229,1220,2163,17,28,30,47,3959,6657,8,943,11,17,2698,2
all,36321.0,Released as a precinct as first report of the night,,48422,100,>98% reported,edison,>98%,48257,2020-11-04T10:44:09Z,R+34,Trump +34,33.99309,republican,Kaufman,31,,,31,48730,4,56435,18290,34399,145,258,526,935,37474,69265,0,16109,113,409,31791,0
unknown,20363.0,Released as a precinct as first report of the night,,23524,100,>98% reported,edison,>98%,48259,2020-11-04T10:44:10Z,R+53,Trump +53,53.20413,republican,Kendall,11,,,11,25521,2,26419,6008,11542,46,78,288,508,20064,37794,34,5534,32,220,17730,8
unknown,104.0,Released as a precinct as first report of the night,,129,80,80% reported,edison,80%,48261,2020-11-04T10:44:10Z,R+32,Trump +32,31.95876,republican,Kenedy,6,,,5,242,2,194,65,108,1,2,1,2,127,211,0,43,1,1,84,0
unknown,353.0,Released as a precinct as first report of the night,,324,82,82% reported,edison,82%,48263,2020-11-04T10:44:10Z,R+79,Trump +79,78.78788,republican,Kent,7,,,6,564,2,462,47,91,3,4,1,1,411,690,0,44,1,0,279,0
unknown,26771.0,Released as a precinct as first report of the night,,24064,96,96% reported,edison,96%,48265,2020-11-04T10:44:11Z,R+52,Trump +52,51.72687,republican,Kerr,21,,,19,28762,4,27738,6510,12326,51,87,283,500,20858,38817,108,5816,36,217,17959,36
unknown,1950.0,Released as a precinct as first report of the night,,1806,99,>98% reported,edison,>98%,48267,2020-11-04T10:44:11Z,R+74,Trump +74,74.30192,republican,Kimble,8,,,7,2305,2,2292,284,507,4,6,17,28,1987,3557,0,223,2,11,1570,0
unknown,125.0,Released as a precinct as first report of the night,,0,77,77% reported,edison,77%,48269,2020-11-04T10:44:11Z,R+90,Trump +90,89.93711,republican,King,5,,,4,207,2,159,8,8,0,0,0,0,151,151,0,0,0,0,0,0
unknown,1498.0,Released as a precinct as first report of the night,,1327,86,86% reported,edison,86%,48271,2020-11-04T10:44:12Z,R+44,Trump +44,43.54336,republican,Kinney,4,,,3,1859,2,1603,446,825,2,3,11,19,1144,2083,0,379,1,8,939,0
unknown,8039.0,Released as a precinct as first report of the night,,8893,89,89% reported,edison,89%,48273,2020-11-04T10:44:12Z,R+1.8,Trump +1.8,1.79332,republican,Kleberg,18,,,16,12366,2,11041,5359,9852,28,46,97,174,5557,9862,0,4493,18,77,4305,0
unknown,343.0,Released as a precinct as first report of the night,,772,82,82% reported,edison,82%,48275,2020-11-04T10:44:13Z,R+63,Trump +63,62.84341,republican,Knox,7,,,6,1783,2,1456,265,412,4,5,7,12,1180,1799,0,147,1,5,619,0
unknown,1195.0,Released as a precinct as first report of the night,,1613,90,90% reported,edison,90%,48283,2020-11-04T10:44:14Z,R+12,Trump +12,11.76226,republican,La Salle,5,,,4,2677,2,2406,1052,1791,7,10,12,18,1335,2200,0,739,3,6,865,0
unknown,5887.0,Released as a precinct as first report of the night,,7338,100,>98% reported,edison,>98%,48285,2020-11-04T10:44:15Z,R+73,Trump +73,73.2614,republican,La Vaca,20,,,18,10228,2,10195,1333,2355,8,12,46,80,8802,15076,16,1022,4,34,6274,4
unknown,15300.0,Released as a precinct as first report of the night,,16690,100,>98% reported,edison,>98%,48277,2020-11-04T10:44:13Z,R+58,Trump +58,57.54054,republican,Lamar,27,,,24,21338,6,21338,4420,8119,27,42,169,283,16698,29539,69,3699,15,114,12841,21
unknown,2723.0,Released as a precinct as first report of the night,,3095,91,91% reported,edison,91%,48279,2020-11-04T10:44:14Z,R+61,Trump +61,60.94675,republican,Lamb,12,,,10,4831,2,4394,835,1428,7,11,38,63,3513,5985,3,593,4,25,2472,1
unknown,6404.0,Released as a precinct as first report of the night,,8639,100,>98% reported,edison,>98%,48281,2020-11-04T10:44:14Z,R+57,Trump +57,57.22549,republican,Lampasas,10,,,10,9690,2,10373,2134,4002,24,37,145,252,8070,14721,0,1868,13,107,6651,0
unknown,5270.0,Released as a precinct as first report of the night,,6548,100,>98% reported,edison,>98%,48287,2020-11-04T10:44:15Z,R+56,Trump +56,55.76471,republican,Lee,16,,,15,7718,2,8075,1745,3217,16,24,65,111,6248,11269,3,1472,8,46,5021,1
some,4924.0,Released as a precinct as first report of the night,,5708,99,>98% reported,edison,>98%,48289,2020-11-04T10:44:15Z,R+74,Trump +74,74.37731,republican,Leon,18,,,16,8785,2,8672,1072,1824,14,24,56,89,7522,12432,19,752,10,33,4910,3
unknown,23806.0,Released as a precinct as first report of the night,,24370,100,>98% reported,edison,>98%,48291,2020-11-04T10:44:15Z,R+60,Trump +60,59.72914,republican,Liberty,30,,,28,28657,2,29314,5779,10423,29,50,218,368,23288,42843,0,4644,21,150,19555,0
unknown,6531.0,Released as a precinct as first report of the night,,6885,99,>98% reported,edison,>98%,48293,2020-11-04T10:44:16Z,R+50,Trump +50,50.29696,republican,Limestone,21,,,19,9139,2,9092,2213,3991,27,47,66,116,6786,11823,0,1778,20,50,5037,0
unknown,482.0,Released as a precinct as first report of the night,,568,86,86% reported,edison,86%,48295,2020-11-04T10:44:16Z,R+79,Trump +79,79.34863,republican,Lipscomb,7,,,5,1573,2,1351,131,206,0,0,17,21,1203,1692,0,75,0,4,489,0
unknown,3171.0,Released as a precinct as first report of the night,,3438,99,>98% reported,edison,>98%,48297,2020-11-04T10:44:16Z,R+67,Trump +67,66.87117,republican,Live Oak,15,,,14,5081,2,5053,819,1414,6,11,30,46,4198,7020,0,595,5,16,2822,0
unknown,11573.0,Released as a precinct as first report of the night,,11919,100,>98% reported,edison,>98%,48299,2020-11-04T10:44:16Z,R+51,Trump +51,51.43094,republican,Llano,10,,,10,12897,2,13278,3167,6144,16,28,99,168,9996,18857,0,2977,12,69,8861,0
unknown,56.0,Released as a precinct as first report of the night,,45,78,78% reported,edison,78%,48301,2020-11-04T10:44:16Z,R+85,Trump +85,84.84848,republican,Loving,5,,,4,85,2,66,4,6,0,0,2,2,60,103,0,2,0,0,43,0
all,108791.0,Released as a precinct as first report of the night,,106281,100,>98% reported,edison,>98%,48303,2020-11-04T10:44:16Z,R+32,Trump +32,32.28096,republican,Lubbock,98,,,92,120204,6,120204,39757,74860,273,478,1604,2827,78560,148300,30,35103,205,1223,69740,10
unknown,1615.0,Released as a precinct as first report of the night,,2293,97,97% reported,edison,97%,48305,2020-11-04T10:44:16Z,R+62,Trump +62,62.14566,republican,Lynn,15,,,13,2373,2,2293,428,856,2,4,10,20,1853,3706,0,428,2,10,1853,0
unknown,4216.0,Released as a precinct as first report of the night,,4377,100,>98% reported,edison,>98%,48313,2020-11-04T10:44:17Z,R+58,Trump +58,58.25298,republican,Madison,5,,,5,5065,2,5289,1084,1996,10,19,30,51,4165,7600,0,912,9,21,3435,0
unknown,3462.0,Released as a precinct as first report of the night,,3723,96,96% reported,edison,96%,48315,2020-11-04T10:44:17Z,R+44,Trump +44,43.93064,republican,Marion,10,,,9,5057,2,4844,1331,2412,8,15,46,74,3459,6066,0,1081,7,28,2607,0
unknown,738.0,Released as a precinct as first report of the night,,1710,100,>98% reported,edison,>98%,48317,2020-11-04T10:44:17Z,R+73,Trump +73,72.63889,republican,Martin,6,,,6,2081,2,2160,288,505,2,3,13,22,1857,3340,0,217,1,9,1483,0
unknown,2092.0,Released as a precinct as first report of the night,,2303,100,>98% reported,edison,>98%,48319,2020-11-04T10:44:17Z,R+57,Trump +57,57.11111,republican,Mason,5,,,5,2429,2,2700,566,1077,2,4,19,34,2108,3883,10,511,2,15,1775,0
unknown,12052.0,Released as a precinct as first report of the night,,10951,95,95% reported,edison,95%,48321,2020-11-04T10:44:17Z,R+45,Trump +45,44.56601,republican,Matagorda,19,,,16,14402,2,13710,3726,6791,33,59,115,194,9836,17617,0,3065,26,79,7781,0
unknown,9456.0,Released as a precinct as first report of the night,,11383,87,87% reported,edison,87%,48323,2020-11-06T22:07:47Z,D+9,Biden +9,9.40801,democrat,Maverick,14,,,14,17664,2,15338,8324,14828,60,103,73,127,6881,11663,0,6504,43,54,4782,0
unknown,3128.0,Released as a precinct as first report of the night,,2668,94,94% reported,edison,94%,48307,2020-11-04T10:44:17Z,R+70,Trump +70,70.20408,republican,McCulloch,4,,,3,3664,2,3430,490,898,6,10,36,61,2898,5129,0,408,4,25,2231,0
unknown,70693.0,Released as a precinct as first report of the night,,80060,100,>98% reported,edison,>98%,48309,2020-11-04T10:44:17Z,R+23,Trump +23,23.44059,republican,McLennan,92,,,87,97624,2,97617,36550,67735,243,420,1291,2195,59432,107151,277,31185,177,904,47719,75
unknown,417.0,Released as a precinct as first report of the night,,366,79,79% reported,edison,79%,48311,2020-11-04T10:44:17Z,R+79,Trump +79,78.87597,republican,McMullen,5,,,4,654,2,516,53,80,1,1,2,4,460,797,0,27,0,2,337,0
unknown,18044.0,Released as a precinct as first report of the night,,19935,100,>98% reported,edison,>98%,48325,2020-11-04T10:43:30Z,R+39,Trump +39,39.29458,republican,Medina,8,,,8,20366,2,22568,6731,12665,44,83,183,326,15599,29408,32,5934,39,143,13809,10
unknown,813.0,Released as a precinct as first report of the night,,798,91,91% reported,edison,91%,48327,2020-11-04T10:43:32Z,R+61,Trump +61,60.89932,republican,Menard,7,,,6,1123,2,1023,196,356,2,3,6,11,819,1451,0,160,1,5,632,0
some,52107.0,Released as a precinct as first report of the night,,49909,97,97% reported,edison,97%,48329,2020-11-04T10:43:33Z,R+57,Trump +57,56.51722,republican,Midland,45,,,41,60756,2,58752,12258,22753,125,227,774,1359,45463,84094,360,10495,102,585,38631,96
unknown,7689.0,Released as a precinct as first report of the night,,8902,100,>98% reported,edison,>98%,48331,2020-11-04T10:43:35Z,R+52,Trump +52,52.02889,republican,Milam,12,,,11,10231,2,10523,2475,4574,24,39,72,126,7950,14682,6,2099,15,54,6732,2
unknown,2437.0,Released as a precinct as first report of the night,,1949,94,94% reported,edison,94%,48333,2020-11-04T10:43:35Z,R+78,Trump +78,77.65787,republican,Mills,8,,,7,2652,2,2502,271,499,2,3,15,24,2214,3925,0,228,1,9,1711,0
some,2166.0,Released as a precinct as first report of the night,,1894,94,94% reported,edison,94%,48335,2020-11-04T10:43:36Z,R+69,Trump +69,68.7088,republican,Mitchell,7,,,6,2735,2,2579,397,691,1,1,11,19,2169,3760,3,294,0,8,1591,1
some,582.0,Released as a precinct as first report of the night,,8042,97,97% reported,edison,97%,48337,2020-11-04T10:43:37Z,R+77,Trump +77,76.60008,republican,Montague,16,,,14,10160,2,9812,1097,2035,24,44,78,142,8613,15633,0,938,20,64,7020,0
some,200221.0,Released as a precinct as first report of the night,,236503,100,>98% reported,edison,>98%,48339,2020-11-04T10:43:38Z,R+44,Trump +44,43.87167,republican,Montgomery,101,,,101,259565,4,271175,74255,140132,522,925,3161,5563,193224,361032,39,65877,403,2402,167808,13
unknown,3973.0,Released as a precinct as first report of the night,,3753,88,88% reported,edison,88%,48341,2020-11-04T10:43:40Z,R+60,Trump +60,59.92366,republican,Moore,8,,,6,6240,2,5502,1059,1624,21,25,66,98,4356,7508,0,565,4,32,3152,0
unknown,4099.0,Released as a precinct as first report of the night,,4130,91,91% reported,edison,91%,48343,2020-11-04T10:43:42Z,R+39,Trump +39,39.23937,republican,Morris,9,,,8,6066,2,5548,1664,2964,7,12,36,56,3841,6646,0,1300,5,20,2805,0
unknown,503.0,Released as a precinct as first report of the night,,443,82,82% reported,edison,82%,48345,2020-11-04T10:43:43Z,R+86,Trump +86,85.58282,republican,Motley,7,,,6,800,2,652,46,80,0,0,2,3,604,1012,0,34,0,1,408,0
unknown,20976.0,Released as a precinct as first report of the night,,22394,96,96% reported,edison,96%,48347,2020-11-04T10:43:44Z,R+31,Trump +31,31.28387,republican,Nacogdoches,26,,,24,27929,2,26755,8989,16942,83,150,302,524,17359,31495,60,7953,67,222,14136,16
unknown,13004.0,Released as a precinct as first report of the night,,14686,98,98% reported,edison,98%,48349,2020-11-04T10:43:45Z,R+45,Trump +45,45.48548,republican,Navarro,30,,,27,19406,2,19105,5097,9528,52,103,167,328,13787,23828,6,4431,51,161,10041,2
unknown,3864.0,Released as a precinct as first report of the night,,4081,88,88% reported,edison,88%,48351,2020-11-04T10:43:46Z,R+61,Trump +61,60.81037,republican,Newton,23,,,19,6911,2,6096,1175,2015,5,7,34,53,4882,8102,0,840,2,19,3220,0
unknown,3284.0,Released as a precinct as first report of the night,,3565,93,93% reported,edison,93%,48353,2020-11-04T10:43:48Z,R+55,Trump +55,55.41854,republican,Nolan,10,,,8,5736,2,5352,1161,2000,10,17,53,81,4127,6817,3,839,7,28,2690,1
unknown,100673.0,Released as a precinct as first report of the night,,110991,94,94% reported,edison,94%,48355,2020-11-04T10:43:50Z,R+3,Trump +3,2.92793,republican,Nueces,128,,,120,135727,2,126984,60749,114670,368,643,1394,2486,64467,120164,18,53921,275,1092,55697,6
unknown,2376.0,Released as a precinct as first report of the night,,2242,89,89% reported,edison,89%,48357,2020-11-04T10:43:51Z,R+80,Trump +80,79.52456,republican,Ochiltree,5,,,4,3545,2,3155,302,506,3,6,37,65,2811,4817,5,204,3,28,2006,1
unknown,538.0,Released as a precinct as first report of the night,,623,82,82% reported,edison,82%,48359,2020-11-04T10:43:52Z,R+83,Trump +83,82.85431,republican,Oldham,8,,,7,1232,2,1009,81,121,1,1,10,15,917,1495,0,40,0,5,578,0
unknown,33059.0,Released as a precinct as first report of the night,,30494,95,95% reported,edison,95%,48361,2020-11-04T10:43:52Z,R+63,Trump +63,63.42358,republican,Orange,35,,,30,37789,2,35974,6354,11841,51,93,375,663,29170,53825,70,5487,42,288,24655,22
unknown,7232.0,Released as a precinct as first report of the night,,9607,100,>98% reported,edison,>98%,48363,2020-11-04T10:43:53Z,R+64,Trump +64,64.05674,republican,Palo Pinto,28,,,26,12128,2,12478,2177,3994,27,46,100,164,10170,17873,12,1817,19,64,7703,4
unknown,9139.0,Released as a precinct as first report of the night,,8092,93,93% reported,edison,93%,48365,2020-11-04T10:43:54Z,R+63,Trump +63,63.4387,republican,Panola,20,,,17,12300,2,11452,2057,3583,11,17,57,94,9322,15840,15,1526,6,37,6518,5
all,50658.0,Released as a precinct as first report of the night,,65348,97,97% reported,edison,97%,48367,2020-11-04T10:43:56Z,R+65,Trump +65,64.68569,republican,Parker,44,,,44,78000,2,75434,12789,24132,155,277,878,1556,61584,114765,80,11343,122,678,53181,24
unknown,1526.0,Released as a precinct as first report of the night,,1316,80,80% reported,edison,80%,48369,2020-11-04T10:43:58Z,R+62,Trump +62,62.12236,republican,Parmer,10,,,8,3309,2,2648,488,695,4,5,23,29,2133,3235,0,207,1,6,1102,0
some,4379.0,Released as a precinct as first report of the night,,3875,86,86% reported,edison,86%,48371,2020-11-04T10:43:59Z,R+39,Trump +39,39.3102,republican,Pecos,10,,,9,5441,2,4668,1378,2562,21,37,50,86,3213,5846,18,1184,16,36,2633,6
unknown,22445.0,Released as a precinct as first report of the night,,20352,100,>98% reported,edison,>98%,48373,2020-11-04T10:44:00Z,R+55,Trump +55,54.5987,republican,Polk,22,,,21,23444,2,24072,5353,10002,50,89,170,306,18496,34021,9,4649,39,136,15525,3
some,24501.0,Released as a precinct as first report of the night,,26844,100,>98% reported,edison,>98%,48375,2020-11-04T10:44:01Z,R+39,Trump +39,38.70104,republican,Potter,25,,,22,33177,6,33242,9867,17852,124,210,454,771,22732,41185,133,7985,86,317,18453,3
unknown,1723.0,Released as a precinct as first report of the night,,1806,77,77% reported,edison,77%,48377,2020-11-04T10:44:01Z,D+33,Biden +33,33.46865,democrat,Presidio,8,,,6,2870,2,2217,1463,2712,12,20,21,38,721,1253,0,1249,8,17,532,0
unknown,3940.0,Released as a precinct as first report of the night,,5032,100,>98% reported,edison,>98%,48379,2020-11-04T10:44:02Z,R+71,Trump +71,71.24421,republican,Rains,9,,,9,5551,2,6044,841,1552,13,22,43,70,5147,9432,0,711,9,27,4285,0
unknown,56579.0,Released as a precinct as first report of the night,,56094,100,>98% reported,edison,>98%,48381,2020-11-04T10:44:02Z,R+66,Trump +66,66.14123,republican,Randall,23,,,23,68884,4,69973,11414,22585,99,192,735,1421,57695,101810,89,11171,93,686,44115,29
unknown,756.0,Released as a precinct as first report of the night,,902,96,96% reported,edison,96%,48383,2020-11-04T10:44:04Z,R+69,Trump +69,68.50534,republican,Reagan,5,,,5,1175,2,1124,172,314,3,6,7,11,942,1695,0,142,3,4,753,0
unknown,1530.0,Released as a precinct as first report of the night,,1638,100,>98% reported,edison,>98%,48385,2020-11-04T10:44:06Z,R+67,Trump +67,66.75076,republican,Real,6,,,5,1985,2,1982,320,591,5,9,14,24,1643,2996,0,271,4,10,1353,0
unknown,5311.0,Released as a precinct as first report of the night,,4263,95,95% reported,edison,95%,48387,2020-11-04T10:44:07Z,R+56,Trump +56,56.36207,republican,Red River,20,,,17,6094,2,5800,1244,2252,7,11,36,57,4513,7743,0,1008,4,21,3230,0
unknown,2241.0,Released as a precinct as first report of the night,,2739,89,89% reported,edison,89%,48389,2020-11-04T11:39:56Z,R+23,Trump +23,23.21477,republican,Reeves,12,,,10,4139,2,3683,1394,2524,8,14,30,48,2249,3832,6,1130,6,18,1583,2
unknown,2120.0,Released as a precinct as first report of the night,,2532,97,97% reported,edison,97%,48391,2020-11-04T10:44:08Z,R+33,Trump +33,32.73916,republican,Refugio,11,,,10,3481,2,3366,1108,1940,21,36,26,41,2210,3879,3,832,15,15,1669,1
unknown,399.0,Released as a precinct as first report of the night,,364,76,76% reported,edison,76%,48393,2020-11-04T10:44:09Z,R+93,Trump +93,93.09091,republican,Roberts,5,,,4,720,2,550,17,27,0,0,4,7,529,880,0,10,0,3,351,0
unknown,7781.0,Released as a precinct as first report of the night,,6537,94,94% reported,edison,94%,48395,2020-11-04T10:44:09Z,R+40,Trump +40,40.49505,republican,Robertson,16,,,14,8605,2,8080,2359,4243,13,21,66,116,5631,10217,31,1884,8,50,4586,9
unknown,36546.0,Released as a precinct as first report of the night,,52457,100,>98% reported,edison,>98%,48397,2020-11-04T10:44:09Z,R+36,Trump +36,35.80599,republican,Rockwall,18,,,18,50672,2,57792,18149,34875,132,243,642,1173,38842,73905,80,16726,111,531,35063,26
unknown,,Released as a precinct as first report of the night,,3082,95,95% reported,edison,95%,48399,2020-11-04T10:44:10Z,R+74,Trump +74,73.93243,republican,Runnels,11,,,10,4467,2,4262,531,917,11,18,38,60,3682,6349,0,386,7,22,2667,0
some,18369.0,Released as a precinct as first report of the night,,16184,95,95% reported,edison,95%,48401,2020-11-04T10:44:10Z,R+56,Trump +56,55.63252,republican,Rusk,23,,,20,22430,4,21367,4624,8301,50,78,154,252,16511,28888,60,3677,28,98,12377,4
unknown,4544.0,Released as a precinct as first report of the night,,4301,99,>98% reported,edison,>98%,48403,2020-11-04T10:44:10Z,R+75,Trump +75,75.15562,republican,Sabine,9,,,8,5492,2,5462,662,1198,7,12,25,44,4767,8508,2,536,5,19,3741,0
unknown,3105.0,Released as a precinct as first report of the night,,2931,92,92% reported,edison,92%,48405,2020-11-04T10:44:11Z,R+51,Trump +51,50.67534,republican,San Augustine,12,,,10,4358,2,3998,979,1777,2,3,12,19,3005,5130,0,798,1,7,2125,0
unknown,9360.0,Released as a precinct as first report of the night,,10413,100,>98% reported,edison,>98%,48407,2020-11-04T10:44:11Z,R+62,Trump +62,61.94172,republican,San Jacinto,12,,,11,12214,2,12628,2332,4298,39,68,101,174,10154,18497,6,1966,29,73,8343,2
all,19161.0,Released as a precinct as first report of the night,,21966,100,>98% reported,edison,>98%,48409,2020-11-04T10:44:11Z,R+29,Trump +29,29.10638,republican,San Patricio,26,,,24,25280,6,25850,8971,16645,93,166,289,512,16495,30489,6,7674,73,223,13994,2
unknown,1940.0,Released as a precinct as first report of the night,,1870,93,93% reported,edison,93%,48411,2020-11-04T10:44:12Z,R+78,Trump +78,77.67102,republican,San Saba,4,,,3,2783,2,2602,287,512,0,0,7,14,2308,3946,0,225,0,7,1638,0
unknown,1035.0,Released as a precinct as first report of the night,,909,93,93% reported,edison,93%,48413,2020-11-04T10:44:13Z,R+63,Trump +63,62.86701,republican,Schleicher,5,,,4,1251,2,1158,211,376,2,4,6,9,939,1678,0,165,2,3,739,0
unknown,4983.0,Released as a precinct as first report of the night,,4639,94,94% reported,edison,94%,48415,2020-11-04T10:44:13Z,R+71,Trump +71,70.92924,republican,Scurry,12,,,10,6246,2,5865,818,1467,15,26,53,87,4978,8923,2,649,11,34,3945,0
unknown,1206.0,Released as a precinct as first report of the night,,1250,88,88% reported,edison,88%,48417,2020-11-04T10:44:13Z,R+83,Trump +83,83.16953,republican,Shackelford,8,,,7,1857,2,1628,130,229,4,7,10,13,1484,2629,0,99,3,3,1145,0
unknown,7145.0,Released as a precinct as first report of the night,,6975,92,92% reported,edison,92%,48419,2020-11-04T10:44:14Z,R+59,Trump +59,58.67038,republican,Shelby,15,,,13,10952,2,10063,2058,3610,4,6,36,58,7962,13360,7,1552,2,22,5398,1
unknown,974.0,Released as a precinct as first report of the night,,684,73,73% reported,edison,73%,48421,2020-11-04T10:44:14Z,R+80,Trump +80,80.20202,republican,Sherman,5,,,4,1349,2,990,91,165,5,8,9,15,885,1486,0,74,3,6,601,0
all,90067.0,Released as a precinct as first report of the night,,87030,100,>98% reported,edison,>98%,48423,2020-11-04T10:44:15Z,R+39,Trump +39,39.39169,republican,Smith,74,,,67,99521,6,99521,29343,55049,253,449,1121,1959,68546,128648,704,25706,196,838,60102,188
unknown,3539.0,Released as a precinct as first report of the night,,4268,100,>98% reported,edison,>98%,48425,2020-11-04T10:44:15Z,R+67,Trump +67,67.42915,republican,Somervell,4,,,4,4811,2,4940,768,1440,10,19,56,95,4099,7642,19,672,9,39,3543,5
unknown,12032.0,Released as a precinct as first report of the night,,14282,99,>98% reported,edison,>98%,48427,2020-11-04T10:44:15Z,D+5,Biden +5,5.00629,democrat,Starr,10,,,10,17600,2,17478,9099,16735,63,119,91,165,8224,14739,3,7636,56,74,6515,1
unknown,3737.0,Released as a precinct as first report of the night,,3017,93,93% reported,edison,93%,48429,2020-11-04T10:44:15Z,R+79,Trump +79,78.6786,republican,Stephens,9,,,8,4087,2,3799,396,726,2,3,16,24,3385,6063,0,330,1,8,2678,0
unknown,408.0,Released as a precinct as first report of the night,,484,78,78% reported,edison,78%,48431,2020-11-04T10:44:15Z,R+83,Trump +83,83.41158,republican,Sterling,4,,,3,823,2,639,51,87,3,5,1,2,584,1029,0,36,2,1,445,0
unknown,437.0,Released as a precinct as first report of the night,,736,81,81% reported,edison,81%,48433,2020-11-04T10:44:16Z,R+68,Trump +68,67.79891,republican,Stonewall,4,,,3,911,2,736,116,232,1,2,4,8,615,1230,0,116,1,4,615,0
unknown,1807.0,Released as a precinct as first report of the night,,1333,80,80% reported,edison,80%,48435,2020-11-04T10:44:16Z,R+58,Trump +58,57.80347,republican,Sutton,5,,,4,1936,2,1557,322,595,4,7,9,13,1222,2275,0,273,3,4,1053,0
unknown,1756.0,Released as a precinct as first report of the night,,1759,88,88% reported,edison,88%,48437,2020-11-04T10:44:16Z,R+58,Trump +58,57.96855,republican,Swisher,9,,,7,2676,2,2353,478,835,10,15,22,36,1842,3225,2,357,5,14,1383,0
all,685898.0,Released as a precinct as first report of the night,,729602,96,96% reported,edison,96%,48439,2020-11-07T02:43:53Z,D+0.16,Biden +0.16,0.16444,democrat,Tarrant,730,,,697,869068,4,830104,409067,772001,2600,4560,10332,18386,407702,764018,1144,362934,1960,8054,356316,338
all,48518.0,Released as a precinct as first report of the night,,45426,100,>98% reported,edison,>98%,48441,2020-11-04T10:44:16Z,R+45,Trump +45,45.42641,republican,Taylor,35,,,32,54924,6,54924,14489,26937,148,261,825,1421,39439,71689,65,12448,113,596,32250,19
unknown,648.0,Released as a precinct as first report of the night,,360,64,64% reported,edison,64%,48443,2020-11-04T10:44:16Z,R+47,Trump +47,46.94323,republican,Terrell,5,,,4,719,2,458,119,219,2,2,3,5,334,592,0,100,0,2,258,0
unknown,3782.0,Released as a precinct as first report of the night,,2879,82,82% reported,edison,82%,48445,2020-11-04T10:44:17Z,R+57,Trump +57,56.87361,republican,Terry,8,,,7,4378,2,3608,757,1353,9,12,33,56,2809,5066,0,596,3,23,2257,0
unknown,614.0,Released as a precinct as first report of the night,,543,85,85% reported,edison,85%,48447,2020-11-04T10:44:17Z,R+81,Trump +81,80.53393,republican,Throckmorton,6,,,5,1057,2,899,82,135,1,2,5,5,806,1290,15,53,1,0,484,5
unknown,7555.0,Released as a precinct as first report of the night,,8230,95,95% reported,edison,95%,48449,2020-11-04T10:44:17Z,R+45,Trump +45,44.73884,republican,Titus,19,,,16,11123,2,10530,2852,5058,19,29,94,159,7563,13510,6,2206,10,65,5947,2
unknown,37998.0,Released as a precinct as first report of the night,,33289,94,94% reported,edison,94%,48451,2020-11-06T22:58:52Z,R+45,Trump +45,44.6036,republican,Tom Green,35,,,35,47505,2,44891,12106,21721,96,147,539,861,32129,55420,52,9615,51,322,23291,10
some,391428.0,Released as a precinct as first report of the night,,553103,99,>98% reported,edison,>98%,48453,2020-11-04T10:44:17Z,D+45,Biden +45,44.98177,democrat,Travis,248,,,246,609336,4,605034,432062,836001,2078,3760,8842,16003,159907,300228,4290,403939,1682,7161,140321,0
unknown,6125.0,Released as a precinct as first report of the night,,5334,94,94% reported,edison,94%,48455,2020-11-04T10:44:17Z,R+61,Trump +61,61.34333,republican,Trinity,20,,,18,7362,2,6938,1323,2350,11,20,25,42,5579,9860,0,1027,9,17,4281,0
unknown,6461.0,Released as a precinct as first report of the night,,6706,100,>98% reported,edison,>98%,48457,2020-11-06T22:48:53Z,R+70,Trump +70,70.23149,republican,Tyler,18,,,11,9466,2,9547,1390,2484,11,17,51,76,8095,13676,0,1094,6,25,5581,0
unknown,12933.0,Released as a precinct as first report of the night,,15342,100,>98% reported,edison,>98%,48459,2020-11-04T10:44:17Z,R+68,Trump +68,68.46684,republican,Upshur,22,,,20,18910,2,18850,2869,5317,22,37,179,284,15775,28545,14,2448,15,105,12770,4
unknown,1421.0,Released as a precinct as first report of the night,,1063,86,86% reported,edison,86%,48461,2020-11-04T10:44:18Z,R+74,Trump +74,73.77289,republican,Upton,5,,,4,1591,2,1365,169,306,7,13,13,23,1176,2086,0,137,6,10,910,0
unknown,10291.0,Released as a precinct as first report of the night,,8194,89,89% reported,edison,89%,48463,2020-11-04T10:44:18Z,R+20,Trump +20,20.2848,republican,Uvalde,14,,,12,11653,2,10323,4066,7530,29,50,66,112,6160,10821,6,3464,21,46,4661,2
some,12685.0,Released as a precinct as first report of the night,,12008,81,81% reported,edison,81%,48465,2020-11-04T10:44:18Z,R+10,Trump +10,9.97434,republican,Val Verde,17,,,14,17702,4,14417,6401,11861,45,78,132,234,7839,14252,0,5460,33,102,6413,0
unknown,15091.0,Released as a precinct as first report of the night,,17151,100,>98% reported,edison,>98%,48467,2020-11-04T10:44:18Z,R+73,Trump +73,72.64008,republican,Van Zandt,19,,,17,25850,2,25753,3419,5826,33,48,175,271,22126,36759,0,2407,15,96,14633,0
unknown,29340.0,Released as a precinct as first report of the night,,27933,93,93% reported,edison,93%,48469,2020-11-04T20:34:51Z,R+38,Trump +38,37.93597,republican,Victoria,35,,,29,36753,2,34205,10371,19101,103,177,338,567,23347,42211,128,8730,74,229,18864,36
all,16785.0,Released as a precinct as first report of the night,,19474,100,>98% reported,edison,>98%,48471,2020-11-04T10:44:18Z,R+32,Trump +32,31.69494,republican,Walker,17,,,16,23641,6,23641,7875,14557,63,109,286,483,15368,27888,127,6682,46,197,12520,29
some,15909.0,Released as a precinct as first report of the night,,19211,100,>98% reported,edison,>98%,48473,2020-11-04T10:43:29Z,R+27,Trump +27,26.86475,republican,Waller,21,,,21,19820,2,22617,8130,15032,82,146,199,342,14206,26308,0,6902,64,143,12102,0
unknown,3020.0,Released as a precinct as first report of the night,,3108,99,>98% reported,edison,>98%,48475,2020-11-04T10:43:29Z,R+61,Trump +61,61.40307,republican,Ward,9,,,8,4069,2,4034,761,1339,6,8,29,47,3238,5748,0,578,2,18,2510,0
unknown,15246.0,Released as a precinct as first report of the night,,14507,95,95% reported,edison,95%,48477,2020-11-04T10:43:31Z,R+50,Trump +50,49.94256,republican,Washington,22,,,20,18306,2,17410,4254,7915,20,32,178,299,12949,23654,26,3661,12,121,10705,8
some,48936.0,Released as a precinct as first report of the night,,53357,92,92% reported,edison,92%,48479,2020-11-05T08:26:54Z,D+23,Biden +23,23.26451,democrat,Webb,70,,,64,73977,2,68439,41820,75274,233,400,446,758,25898,45322,84,33454,167,312,19424,0
unknown,14576.0,Released as a precinct as first report of the night,,14497,96,96% reported,edison,96%,48481,2020-11-04T10:49:55Z,R+43,Trump +43,43.21623,republican,Wharton,13,,,11,17397,2,16709,4671,8632,36,65,105,190,11892,22314,10,3961,29,85,10422,0
unknown,1640.0,Released as a precinct as first report of the night,,1643,86,86% reported,edison,86%,48483,2020-11-04T10:43:35Z,R+85,Trump +85,85.18836,republican,Wheeler,11,,,9,2723,2,2336,168,297,3,5,7,10,2158,3667,0,129,2,3,1509,0
some,45995.0,Released as a precinct as first report of the night,,37719,90,90% reported,edison,90%,48485,2020-11-06T04:11:46Z,R+41,Trump +41,41.32188,republican,Wichita,62,,,57,50639,2,45753,13024,23820,125,215,664,1138,31930,58280,29,10796,90,474,26350,9
unknown,4072.0,Released as a precinct as first report of the night,,3739,93,93% reported,edison,93%,48487,2020-11-04T10:43:37Z,R+57,Trump +57,56.79504,republican,Wilbarger,5,,,4,4848,2,4518,954,1731,11,16,33,56,3520,6454,0,777,5,23,2934,0
unknown,3321.0,Released as a precinct as first report of the night,,3554,84,84% reported,edison,84%,48489,2020-11-04T10:43:37Z,D+12,Biden +12,11.83857,democrat,Willacy,17,,,14,6624,2,5575,3097,5213,16,23,25,40,2437,3853,0,2116,7,15,1416,0
all,172960.0,Released as a precinct as first report of the night,,261300,100,>98% reported,edison,>98%,48491,2020-11-04T10:43:38Z,D+1.3,Biden +1.3,1.32362,democrat,Williamson,58,,,58,285000,4,287696,142457,275069,782,1419,4961,9009,138649,262452,1894,132612,637,4048,123803,200
unknown,17031.0,Released as a precinct as first report of the night,,20881,100,>98% reported,edison,>98%,48493,2020-11-04T10:43:40Z,R+48,Trump +48,48.41638,republican,Wilson,17,,,17,22948,2,25006,6350,11835,39,69,150,273,18457,33700,20,5485,30,123,15243,0
unknown,1480.0,Released as a precinct as first report of the night,,1469,87,87% reported,edison,87%,48495,2020-11-04T10:43:41Z,R+66,Trump +66,65.61618,republican,Winkler,6,,,5,2439,2,2126,358,620,1,2,14,23,1753,2950,0,262,1,9,1197,0
unknown,19355.0,Released as a precinct as first report of the night,,27362,100,>98% reported,edison,>98%,48497,2020-11-04T10:43:42Z,R+68,Trump +68,68.21996,republican,Wise,26,,,26,29258,2,32297,4953,9218,47,78,308,537,26986,49822,7,4265,31,229,22836,1
unknown,14753.0,Released as a precinct as first report of the night,,19451,100,>98% reported,edison,>98%,48499,2020-11-04T10:43:43Z,R+68,Trump +68,68.27708,republican,Wood,14,,,13,22115,2,22665,3487,6601,40,73,175,301,18962,35140,2,3114,33,126,16178,0
some,2155.0,Released as a precinct as first report of the night,,2134,88,88% reported,edison,88%,48501,2020-11-04T10:43:44Z,R+67,Trump +67,66.57805,republican,Yoakum,7,,,6,2994,2,2633,419,727,6,11,31,52,2172,3967,15,308,5,21,1795,5
unknown,9164.0,Released as a precinct as first report of the night,,7088,91,91% reported,edison,91%,48503,2020-11-04T10:43:45Z,R+74,Trump +74,73.71997,republican,Young,10,,,8,9101,2,8242,1036,1931,18,34,76,139,7112,13226,0,895,16,63,6114,0
unknown,3125.0,Released as a precinct as first report of the night,,2438,84,84% reported,edison,84%,48505,2020-11-04T10:43:46Z,R+5,Trump +5,5.48229,republican,Zapata,8,,,8,4606,2,3867,1820,3055,4,6,11,20,2032,3224,0,1235,2,9,1192,0
unknown,3597.0,Released as a precinct as first report of the night,,2968,92,92% reported,edison,92%,48507,2020-11-04T10:43:48Z,D+31,Biden +31,31.37703,democrat,Zavala,6,,,6,4749,2,4379,2864,4981,12,17,13,18,1490,2331,0,2117,5,5,841,0
